доступный:  доступный
файл:  файл
пойти:  пойти
разместить:  разместить
особо:  особо
использовать:  использовать
утилит:  утилит
страница:  страница
софт:  софт
загружаться:  загружаться
использование:  использование
отключаться:  отключаться
разработать:  разработать
нравиться:  нравиться
шкала:  шкала
запуск:  запуск
рабочий:  рабочий
многие:  многие
плавать:  плавать
отличие:  отличие
поиск:  поиск
заголовок:  заголовок
думать:  думать
неожиданность:  неожиданность
человек:  человек
конфигурация:  конфигурация
произвести:  произвести
рано:  рано
вкладка:  вкладка
показать:  показать
пк:  пк
столько:  столько
статья:  статья
образ:  образ
день:  день
нужный:  нужный
количество:  количество
увеличение:  увеличение
крайне:  крайне
игра:  игра
далее:  далее
лечение:  лечение
заключаться:  заключаться
замечать:  замечать
вирус:  вирус
она:  она
установить:  установить
поздно:  поздно
диск:  диск
нет:  нет
нажать:  нажать
двигаться:  двигаться
относиться:  относиться
редко:  редко
пользователь:  пользователь
работать:  работать
четырнадцать:  четырнадцать
реклама:  реклама
ресурс:  ресурс
удаление:  удаление
нести:  нести
способ:  способ
работа:  работа
почти:  почти
нечисть:  нечисть
всё:  всё
разработчик:  разработчик
открыть:  открыть
доставлять:  доставлять
комментарий:  комментарий
порой:  порой
стать:  стать
обмен:  обмен
удалить:  удалить
закрывать:  закрывать
найти:  найти
ненавидеть:  ненавидеть
база:  база
кнопка:  кнопка
программа:  программа
становиться:  становиться
сочетание:  сочетание
увеличить:  увеличить
утилита:  утилита
интересовать:  интересовать
данные:  данные
случай:  случай
всегда:  всегда
ссылка:  ссылка
стол:  стол
кто:  кто
направление:  направление
открыться:  открыться
помочь:  помочь
это:  это
скатить:  скатить
особенно:  особенно
быстро:  быстро
видеть:  видеть
браузер:  браузер
одновременно:  одновременно
есть:  есть
нужно:  нужно
оболочка:  оболочка
только:  только
аквариум:  аквариум
более:  более
тема:  тема
блог:  блог
жить:  жить
производительность:  производительность
яндекс:  яндекс
фауна:  фауна
оставлять:  оставлять
установка:  установка
удалять:  удалять
встроить:  встроить
быть:  быть
загружать:  загружать
формат:  формат
происходить:  происходить
освободить:  освободить
менее:  менее
защита:  защита
текст:  текст
заставка:  заставка
выключение:  выключение
улучшение:  улучшение
инсталляция:  инсталляция
беспокойство:  беспокойство
сопровождение:  сопровождение
клавиша:  клавиша
море:  море
бесплатно:  бесплатно
избавиться:  избавиться
сайт:  сайт
решить:  решить
ноутбук:  ноутбук
случайно:  случайно
писать:  писать
последствие:  последствие
смотреться:  смотреться
восстановить:  восстановить
объединить:  объединить
постоянно:  постоянно
менять:  менять
вводить:  вводить
почистить:  почистить
перезагрузка:  перезагрузка
место:  место
я:  я
сообщение:  сообщение
скачать:  скачать
апрель:  апрель
проверка:  проверка
куча:  куча
теперь:  теперь
допускать:  допускать
терять:  терять
возникнуть:  возникнуть
проходить:  проходить
разделить:  разделить
объём:  объём
безопасность:  безопасность
версия:  версия
он:  он
величина:  величина
найтись:  найтись
давно:  давно
они:  они
компьютер:  компьютер
запустить:  запустить
галочка:  галочка
красота:  красота
момент:  момент
можно:  можно
нажатие:  нажатие
мелодия:  мелодия
оформление:  оформление
флешка:  флешка
критически:  критически
остановить:  остановить
чистка:  чистка
система:  система
сеть:  сеть
пройти:  пройти
загрузка:  загрузка
произойти:  произойти
вставить:  вставить
ни:  ни
умолчание:  умолчание
душа:  душа
достаточно:  достаточно
выбрать:  выбрать
вручную:  вручную
убрать:  убрать
оптимизация:  оптимизация
понять:  понять
иногда:  иногда
обращать:  обращать
кратко:  кратко
категория:  категория
желательно:  желательно
написать:  написать
раз:  раз
речь:  речь
отключить:  отключить
попасться:  попасться
восстановление:  восстановление
много:  много
пароль:  пароль
перенести:  перенести
раскрыть:  раскрыть
вопрос:  вопрос
медленно:  медленно
известный:  известный
просто:  просто
отобразить:  отобразить
глаз:  глаз
очень:  очень
попасть:  попасть
память:  память
вместе:  вместе
воровать:  воровать
монитор:  монитор
рыбка:  рыбка
читать:  читать
не:  не
средство:  средство
устанавливать:  устанавливать
возможность:  возможность
океан:  океан
март:  март
папка:  папка
вероятность:  вероятность
подкачка:  подкачка
лично:  лично
дело:  дело
буфер:  буфер
потому:  потому
внимание:  внимание
придача:  придача
компания:  компания
специализировать:  специализировать
помощь:  помощь
окошко:  окошко
долгий:  долгий
гармонично:  гармонично
очистить:  очистить
очистка:  очистка
мусор:  мусор
цвет:  цвет
совсем:  совсем
весить:  весить
открываться:  открываться
выручить:  выручить
ещё:  ещё
говориться:  говориться
четыре:  четыре
размер:  размер
обитатель:  обитатель
навигация:  навигация
сталкиваться:  сталкиваться
обновление:  обновление
реалистичность:  реалистичность
строка:  строка
украшение:  украшение
практически:  практически
цитата:  цитата
