узнать:  узнать
подпись:  подпись
заказать:  заказать
сеть:  сеть
далёкий:  далёкий
онлайн:  онлайн
тэк:  тэк
ключ:  ключ
минута:  минута
позволять:  позволять
оператор:  оператор
заявка:  заявка
получение:  получение
сертификат:  сертификат
аста:  аста
выпуск:  выпуск
программа:  программа
июль:  июль
оперативно:  оперативно
выдача:  выдача
вс:  вс
имущество:  имущество
возникать:  возникать
сообщение:  сообщение
торг:  торг
многое:  многое
регистратор:  регистратор
помощь:  помощь
оперативность:  оперативность
алкоголь:  алкоголь
сергей:  сергей
сдача:  сдача
доступ:  доступ
реализация:  реализация
фз:  фз
имя:  имя
читать:  читать
драйвер:  драйвер
целое:  целое
удостоверять:  удостоверять
центр:  центр
атрибут:  атрибут
момент:  момент
подача:  подача
отчётность:  отчётность
устранить:  устранить
работа:  работа
бесплатно:  бесплатно
ошибка:  ошибка
зао:  зао
площадка:  площадка
портал:  портал
скачать:  скачать
авторизоваться:  авторизоваться
отзывчивость:  отзывчивость
изменение:  изменение
раскрытие:  раскрытие
удобно:  удобно
доверие:  доверие
звонить:  звонить
настройка:  настройка
пройти:  пройти
взаимодействие:  взаимодействие
курс:  курс
точка:  точка
тема:  тема
конкурс:  конкурс
утилит:  утилит
только:  только
руководитель:  руководитель
сми:  сми
плагин:  плагин
город:  город
процесс:  процесс
фнс:  фнс
специалист:  специалист
всё:  всё
где:  где
ип:  ип
носитель:  носитель
илья:  илья
связь:  связь
год:  год
шифрование:  шифрование
сфера:  сфера
происходить:  происходить
регистрация:  регистрация
неправильно:  неправильно
внесение:  внесение
специализировать:  специализировать
телефон:  телефон
сервис:  сервис
оформление:  оформление
агент:  агент
очень:  очень
не:  не
корректно:  корректно
это:  это
лицензия:  лицензия
она:  она
дать:  дать
пространство:  пространство
можно:  можно
касса:  касса
форма:  форма
компьютер:  компьютер
компонент:  компонент
документ:  документ
лицо:  лицо
большинство:  большинство
спасибо:  спасибо
новость:  новость
настроить:  настроить
просто:  просто
банкрот:  банкрот
вы:  вы
сайт:  сайт
купить:  купить
кто:  кто
ольга:  ольга
комплекс:  комплекс
теперь:  теперь
госуслуга:  госуслуга
оформить:  оформить
гражданин:  гражданин
квалифицировать:  квалифицировать
карта:  карта
получать:  получать
представить:  представить
оформляться:  оформляться
предприниматель:  предприниматель
обзор:  обзор
нужный:  нужный
решение:  решение
услуга:  услуга
оказать:  оказать
закупка:  закупка
общение:  общение
подписывать:  подписывать
средство:  средство
вежливость:  вежливость
устройство:  устройство
страница:  страница
забыть:  забыть
порядок:  порядок
раздел:  раздел
сбербанк:  сбербанк
вид:  вид
закон:  закон
абсолютно:  абсолютно
меняться:  меняться
более:  более
применение:  применение
цепочка:  цепочка
связать:  связать
прямо:  прямо
автоматизация:  автоматизация
компания:  компания
аккредитация:  аккредитация
работать:  работать
кабинет:  кабинет
оставить:  оставить
дом:  дом
вопрос:  вопрос
получить:  получить
пять:  пять
прайс-лист:  прайс-лист
хранение:  хранение
управление:  управление
регламент:  регламент
поставить:  поставить
мы:  мы
