звук:  звук
обуславливать:  обуславливать
протокол:  протокол
интерфейс:  интерфейс
поток:  поток
упомянуть:  упомянуть
оптимизация:  оптимизация
рекомендовать:  рекомендовать
файл:  файл
переустановка:  переустановка
просмотр:  просмотр
редактор:  редактор
отчёт:  отчёт
скатить:  скатить
использовать:  использовать
моделирование:  моделирование
передача:  передача
сайт:  сайт
запись:  запись
источник:  источник
уметь:  уметь
поиск:  поиск
перейти:  перейти
поступление:  поступление
синхронизация:  синхронизация
продвинуть:  продвинуть
интерьер:  интерьер
упрощать:  упрощать
модуль:  модуль
комплекс:  комплекс
стоить:  стоить
поддерживать:  поддерживать
участник:  участник
иметь:  иметь
система:  система
активно:  активно
информация:  информация
среда:  среда
модель:  модель
сеть:  сеть
использоваться:  использоваться
трансляция:  трансляция
характеристика:  характеристика
браузер:  браузер
сохранить:  сохранить
сектор:  сектор
копирование:  копирование
всё:  всё
веб-браузер:  веб-браузер
абсолютно:  абсолютно
сервер:  сервер
ремонт:  ремонт
дизайн:  дизайн
умолчание:  умолчание
часть:  часть
работа:  работа
сделать:  сделать
утилита:  утилита
соединение:  соединение
раздел:  раздел
особенность:  особенность
астрология:  астрология
создать:  создать
упор:  упор
категория:  категория
предназначение:  предназначение
результат:  результат
микшер:  микшер
создание:  создание
обладать:  обладать
управлять:  управлять
сообщение:  сообщение
вестись:  вестись
данные:  данные
игра:  игра
движок:  движок
контроль:  контроль
содержимое:  содержимое
шифроваться:  шифроваться
это:  это
план:  план
писать:  писать
соблюдение:  соблюдение
встроить:  встроить
компьютер:  компьютер
вывод:  вывод
воспроизведение:  воспроизведение
скорость:  скорость
возможность:  возможность
карта:  карта
сохранять:  сохранять
полностью:  полностью
профиль:  профиль
анимация:  анимация
уровень:  уровень
антивирус:  антивирус
формат:  формат
функция:  функция
обработка:  обработка
выводиться:  выводиться
программа:  программа
форум:  форум
добавлять:  добавлять
более:  более
позволять:  позволять
утратить:  утратить
использование:  использование
продукт:  продукт
умение:  умение
работать:  работать
пользователь:  пользователь
разработчик:  разработчик
структура:  структура
являться:  являться
состояние:  состояние
изменять:  изменять
большинство:  большинство
исключение:  исключение
тест:  тест
присутствовать:  присутствовать
клиент:  клиент
поддержка:  поддержка
пароль:  пароль
вывести:  вывести
страница:  страница
входить:  входить
редактирование:  редактирование
статья:  статья
разнообразие:  разнообразие
главное:  главное
метод:  метод
помощь:  помощь
генеалогия:  генеалогия
функционал:  функционал
ввод:  ввод
выбирать:  выбирать
наличие:  наличие
изменение:  изменение
музыка:  музыка
год:  год
включить:  включить
выполнение:  выполнение
обмен:  обмен
видео:  видео
воссоздавать:  воссоздавать
восстановление:  восстановление
каталог:  каталог
переключение:  переключение
не:  не
подключить:  подключить
аудио:  аудио
уязвимость:  уязвимость
аудиоредактор:  аудиоредактор
накопитель:  накопитель
настройка:  настройка
защита:  защита
узел:  узел
форматирование:  форматирование
практически:  практически
загрузка:  загрузка
основать:  основать
идентификация:  идентификация
описание:  описание
сценарий:  сценарий
диск:  диск
подключение:  подключение
реализация:  реализация
обзор:  обзор
задать:  задать
веб-сайт:  веб-сайт
отправлять:  отправлять
торрент:  торрент
просмотреть:  просмотреть
пересоздавать:  пересоздавать
чат:  чат
совершение:  совершение
память:  память
прекрасно:  прекрасно
состав:  состав
авторизация:  авторизация
находиться:  находиться
составлять:  составлять
доступный:  доступный
архиватор:  архиватор
код:  код
ссылка:  ссылка
запуск:  запуск
проработать:  проработать
жизнь:  жизнь
необходимо:  необходимо
пакет:  пакет
устройство:  устройство
версия:  версия
восстановить:  восстановить
безопасность:  безопасность
дать:  дать
микширование:  микширование
добавление:  добавление
текстура:  текстура
читать:  читать
агрегатор:  агрегатор
вещание:  вещание
веб:  веб
просматривать:  просматривать
они:  они
можно:  можно
компания:  компания
автоматически:  автоматически
конвейер:  конвейер
действие:  действие
кодек:  кодек
детально:  детально
многое:  многое
легко:  легко
