энергия:  энергия
автовокзал:  автовокзал
перейти:  перейти
обеспечивать:  обеспечивать
виктор:  виктор
совет:  совет
располагать:  располагать
это:  это
не:  не
компания:  компания
продажа:  продажа
режим:  режим
обслуживание:  обслуживание
содержание:  содержание
внедрять:  внедрять
сегодня:  сегодня
оборудование:  оборудование
сервис:  сервис
процесс:  процесс
автоматизация:  автоматизация
безопасность:  безопасность
опыт:  опыт
прокрутка:  прокрутка
сохранить:  сохранить
банк:  банк
внедрение:  внедрение
сопровождение:  сопровождение
служба:  служба
донецк:  донецк
преувеличение:  преувеличение
зарплата:  зарплата
комбинат:  комбинат
страна:  страна
связаться:  связаться
сергеевич:  сергеевич
правительство:  правительство
азербайджан:  азербайджан
инжиниринг:  инжиниринг
вверх:  вверх
техника:  техника
доводить:  доводить
стандарт:  стандарт
бизнес:  бизнес
клиент:  клиент
технология:  технология
обслуживать:  обслуживать
министерство:  министерство
создание:  создание
рынок:  рынок
группа:  группа
мы:  мы
теперь:  теперь
пять:  пять
проводить:  проводить
территория:  территория
дело:  дело
область:  область
ремонт:  ремонт
код:  код
норма:  норма
меню:  меню
фабрика:  фабрика
хлеб:  хлеб
гостиница:  гостиница
штат:  штат
республика:  республика
смочь:  смочь
осуществляться:  осуществляться
сфера:  сфера
днр:  днр
предприятие:  предприятие
завод:  завод
управление:  управление
спирт:  спирт
инсталлировать:  инсталлировать
ресурс:  ресурс
россия:  россия
разработка:  разработка
соответствие:  соответствие
казахстан:  казахстан
тор:  тор
деятельность:  деятельность
входить:  входить
проект:  проект
корпорация:  корпорация
государство:  государство
руководитель:  руководитель
бухгалтерия:  бухгалтерия
порядок:  порядок
соответствовать:  соответствовать
наука:  наука
образование:  образование
обслуживаться:  обслуживаться
ооо:  ооо
опера:  опера
донбасс:  донбасс
учёт:  учёт
финансы:  финансы
сотрудник:  сотрудник
урожай:  урожай
студия:  студия
блог:  блог
галактика:  галактика
просто:  просто
работа:  работа
контакт:  контакт
разработать:  разработать
год:  год
наводить:  наводить
поставка:  поставка
всё:  всё
охрана:  охрана
казначейство:  казначейство
телефон:  телефон
ещё:  ещё
условие:  условие
труд:  труд
квалифицировать:  квалифицировать
политика:  политика
обусловить:  обусловить
система:  система
являться:  являться
закрыть:  закрыть
агентство:  агентство
хозяйство:  хозяйство
строительство:  строительство
возглавлять:  возглавлять
супермаркет:  супермаркет
лента:  лента
лидер:  лидер
ситуация:  ситуация
специалист:  специалист
мвд:  мвд
часть:  часть
маршал:  маршал
конец:  конец
разбираться:  разбираться
список:  список
отрасль:  отрасль
обращение:  обращение
