анализ:  анализ
специалист:  специалист
она:  она
страх:  страх
помогать:  помогать
использование:  использование
экспертиза:  экспертиза
выбрать:  выбрать
потребность:  потребность
качество:  качество
софт:  софт
автоматизация:  автоматизация
пра:  пра
продукт:  продукт
центр:  центр
редактор:  редактор
изучать:  изучать
пресс-центр:  пресс-центр
минск:  минск
форум:  форум
фреймворк:  фреймворк
задать:  задать
сэкономить:  сэкономить
область:  область
вызов:  вызов
внедрять:  внедрять
согласие:  согласие
разработчик:  разработчик
раз:  раз
улучшить:  улучшить
обмениваться:  обмениваться
эффективность:  эффективность
машиностроение:  машиностроение
статус:  статус
препятствие:  препятствие
конференция:  конференция
данные:  данные
производство:  производство
партнёр:  партнёр
индустрия:  индустрия
учёт:  учёт
сурганов:  сурганов
брокер:  брокер
база:  база
вникать:  вникать
развивать:  развивать
создание:  создание
развитие:  развитие
веб-сервис:  веб-сервис
страница:  страница
ресурс:  ресурс
работа:  работа
проводить:  проводить
всё:  всё
срок:  срок
вы:  вы
масштаб:  масштаб
особенность:  особенность
риск:  риск
предприятие:  предприятие
процесс:  процесс
подход:  подход
онлайн:  онлайн
возможность:  возможность
бизнес-процесс:  бизнес-процесс
персонал:  персонал
тариф:  тариф
сеть:  сеть
комплекс:  комплекс
иса:  иса
организация:  организация
подтверждать:  подтверждать
информация:  информация
отрасль:  отрасль
заказ:  заказ
менеджмент:  менеджмент
сопровождение:  сопровождение
построение:  построение
лицензия:  лицензия
стандарт:  стандарт
глубоко:  глубоко
директор:  директор
производительность:  производительность
рамка:  рамка
контроль:  контроль
заниматься:  заниматься
набор:  набор
беларусь:  беларусь
бизнес:  бизнес
представить:  представить
специально:  специально
конфиденциальность:  конфиденциальность
услуга:  услуга
эффект:  эффект
платформа:  платформа
экосистема:  экосистема
выбор:  выбор
осуществлять:  осуществлять
боеприпас:  боеприпас
клиент:  клиент
поставлять:  поставлять
интеграция:  интеграция
переход:  переход
технология:  технология
сайт:  сайт
предлагать:  предлагать
провести:  провести
выполнение:  выполнение
цель:  цель
создавать:  создавать
бизнес-задача:  бизнес-задача
металлообработка:  металлообработка
управление:  управление
ведение:  ведение
ооо:  ооо
менять:  менять
обучение:  обучение
разрабатывать:  разрабатывать
галактика:  галактика
обсуждать:  обсуждать
обработка:  обработка
интуитивно:  интуитивно
компетенция:  компетенция
мы:  мы
он:  он
система:  система
обеспечение:  обеспечение
внедрение:  внедрение
вопрос:  вопрос
хранение:  хранение
сектор:  сектор
сфера:  сфера
получать:  получать
прибыль:  прибыль
аттестация:  аттестация
приумножить:  приумножить
задача:  задача
проект:  проект
эхо:  эхо
недавно:  недавно
процедура:  процедура
время:  время
политика:  политика
бизнес-сообщество:  бизнес-сообщество
ответственность:  ответственность
передавать:  передавать
ряд:  ряд
нефтепродукт:  нефтепродукт
история:  история
результат:  результат
ход:  ход
себя:  себя
мешать:  мешать
планировать:  планировать
подготовка:  подготовка
карта:  карта
многое:  многое
они:  они
актив:  актив
мониторинг:  мониторинг
проведение:  проведение
пройти:  пройти
доступ:  доступ
условие:  условие
затем:  затем
серия:  серия
итог:  итог
погибнуть:  погибнуть
включать:  включать
создать:  создать
ускорить:  ускорить
знание:  знание
бросать:  бросать
строительство:  строительство
республика:  республика
соглашаться:  соглашаться
полтора:  полтора
сопровождать:  сопровождать
представление:  представление
преодолеть:  преодолеть
вертикаль:  вертикаль
отправить:  отправить
иногда:  иногда
расширение:  расширение
ин:  ин
выявлять:  выявлять
отношение:  отношение
поддержка:  поддержка
промышленность:  промышленность
поставщик:  поставщик
заказчик:  заказчик
н:  н
обладать:  обладать
решение:  решение
компания:  компания
просто:  просто
изучение:  изучение
вуз:  вуз
собрать:  собрать
студент:  студент
консалтинг:  консалтинг
быть:  быть
тренинг:  тренинг
предоставлять:  предоставлять
бизнес-модель:  бизнес-модель
путь:  путь
алгоритм:  алгоритм
устояться:  устояться
день:  день
сочетание:  сочетание
выполнять:  выполнять
использоваться:  использоваться
безопасность:  безопасность
опережать:  опережать
принятие:  принятие
не:  не
проводиться:  проводиться
защита:  защита
топ:  топ
повышать:  повышать
представлять:  представлять
испытание:  испытание
экономика:  экономика
обсуждаться:  обсуждаться
проблема:  проблема
обрабатывать:  обрабатывать
новость:  новость
стартовать:  стартовать
борьба:  борьба
контрагент:  контрагент
писать:  писать
переосмыслить:  переосмыслить
взаимоотношение:  взаимоотношение
обеспечивать:  обеспечивать
повышение:  повышение
состояние:  состояние
сертифицировать:  сертифицировать
капитал:  капитал
показатель:  показатель
участие:  участие
мероприятие:  мероприятие
разработать:  разработать
трансформация:  трансформация
помощь:  помощь
план:  план
вводить:  вводить
взаимодействие:  взаимодействие
контакт:  контакт
препятствовать:  препятствовать
оптимизация:  оптимизация
внедрить:  внедрить
сбыт:  сбыт
разработка:  разработка
горизонталь:  горизонталь
обновление:  обновление
схема:  схема
шина:  шина
