возвращаться:  возвращаться
мы:  мы
бизнес:  бизнес
соответствие:  соответствие
шина:  шина
зависимость:  зависимость
напугать:  напугать
агентство:  агентство
доставка:  доставка
телефон:  телефон
сеть:  сеть
прайс-лист:  прайс-лист
сайт:  сайт
связаться:  связаться
клиент:  клиент
кафе:  кафе
бы:  бы
выбирать:  выбирать
написать:  написать
хранение:  хранение
рейтинг:  рейтинг
отправить:  отправить
цифра:  цифра
работа:  работа
оборудование:  оборудование
начать:  начать
закон:  закон
я:  я
вы:  вы
реклама:  реклама
текстиль:  текстиль
давать:  давать
рунет:  рунет
продукция:  продукция
ниша:  ниша
подробный:  подробный
революция:  революция
всё:  всё
россия:  россия
снять:  снять
цель:  цель
интернет-магазин:  интернет-магазин
лицо:  лицо
фабрика:  фабрика
школа:  школа
вникать:  вникать
разработка:  разработка
остаться:  остаться
диск:  диск
продукт:  продукт
версия:  версия
не:  не
станкостроение:  станкостроение
передача:  передача
награда:  награда
еда:  еда
ноша:  ноша
он:  он
разработчик:  разработчик
глубоко:  глубоко
вопрос:  вопрос
почта:  почта
кнопка:  кнопка
согласие:  согласие
нажимать:  нажимать
стратегия:  стратегия
презентация:  презентация
предлагать:  предлагать
проблема:  проблема
количество:  количество
услуга:  услуга
специфика:  специфика
чебоксары:  чебоксары
данные:  данные
политика:  политика
место:  место
имя:  имя
право:  право
поддержка:  поддержка
пора:  пора
постоянно:  постоянно
минимально:  минимально
достигнуть:  достигнуть
скачать:  скачать
