провести:  провести
услуга:  услуга
доступный:  доступный
интересовать:  интересовать
поведение:  поведение
она:  она
оператор:  оператор
источник:  источник
заполнять:  заполнять
чат:  чат
режим:  режим
набор:  набор
помочь:  помочь
часть:  часть
сумма:  сумма
подключиться:  подключиться
узнать:  узнать
товар:  товар
стать:  стать
зарегистрироваться:  зарегистрироваться
настроить:  настроить
задавать:  задавать
удалять:  удалять
обратиться:  обратиться
закрывать:  закрывать
часто:  часто
оформить:  оформить
круглосуточно:  круглосуточно
подключить:  подключить
сервис:  сервис
связь:  связь
что:  что
не:  не
увидеть:  увидеть
получить:  получить
день:  день
количество:  количество
задать:  задать
сравнение:  сравнение
выбор:  выбор
курс:  курс
пропустить:  пропустить
раздел:  раздел
конкурент:  конкурент
уведомить:  уведомить
план:  план
поднять:  поднять
уточнить:  уточнить
большой:  большой
он:  он
запрос:  запрос
сообщение:  сообщение
модуль:  модуль
клиент:  клиент
соцсеть:  соцсеть
работать:  работать
знание:  знание
предложить:  предложить
автоматически:  автоматически
решать:  решать
настроение:  настроение
устанавливаться:  устанавливаться
я:  я
заполнить:  заполнить
настраивать:  настраивать
брать:  брать
мышь:  мышь
начать:  начать
заходить:  заходить
браузер:  браузер
тратить:  тратить
страница:  страница
сто:  сто
работа:  работа
отреагировать:  отреагировать
внести:  внести
всё:  всё
компания:  компания
долго:  долго
выбирать:  выбирать
именно:  именно
меню:  меню
найти:  найти
риск:  риск
посетитель:  посетитель
дизайн:  дизайн
легко:  легко
шаг:  шаг
занять:  занять
смочь:  смочь
заново:  заново
потребитель:  потребитель
объяснять:  объяснять
поиск:  поиск
просмотреть:  просмотреть
поменять:  поменять
получать:  получать
зачем:  зачем
просмотр:  просмотр
диалог:  диалог
онлайн:  онлайн
принимать:  принимать
направление:  направление
это:  это
сделать:  сделать
коммуникация:  коммуникация
удобство:  удобство
привлечение:  привлечение
канал:  канал
заставить:  заставить
быстро:  быстро
повышать:  повышать
написать:  написать
дать:  дать
информация:  информация
оплатить:  оплатить
обращаться:  обращаться
конверсия:  конверсия
позволять:  позволять
нужно:  нужно
партнёр:  партнёр
только:  только
более:  более
указать:  указать
быть:  быть
проблема:  проблема
вперёд:  вперёд
сейчас:  сейчас
ответ:  ответ
проделывать:  проделывать
просматривать:  просматривать
можно:  можно
сторона:  сторона
конфиденциальность:  конфиденциальность
продавать:  продавать
происходить:  происходить
оперативно:  оперативно
статус:  статус
платёж:  платёж
инструкция:  инструкция
вы:  вы
новость:  новость
текст:  текст
бизнес:  бизнес
функция:  функция
курсор:  курсор
передать:  передать
точно:  точно
стоимость:  стоимость
сайт:  сайт
ошибка:  ошибка
продолжить:  продолжить
мочь:  мочь
предлагать:  предлагать
назад:  назад
гарантированно:  гарантированно
эмоция:  эмоция
консультировать:  консультировать
бесплатно:  бесплатно
возможность:  возможность
подробный:  подробный
ооо:  ооо
программа:  программа
устройство:  устройство
знать:  знать
прийти:  прийти
контакт:  контакт
цена:  цена
переписка:  переписка
продвинуть:  продвинуть
отзыв:  отзыв
вкладка:  вкладка
использовать:  использовать
установить:  установить
мы:  мы
система:  система
наладить:  наладить
технология:  технология
вопрос:  вопрос
способ:  способ
отправить:  отправить
сразу:  сразу
клик:  клик
ос:  ос
ни:  ни
прямо:  прямо
регион:  регион
интегрировать:  интегрировать
превратить:  превратить
скачать:  скачать
время:  время
список:  список
пользователь:  пользователь
рейтинг:  рейтинг
политика:  политика
форма:  форма
результат:  результат
смайлик:  смайлик
меняться:  меняться
отвечать:  отвечать
сориентировать:  сориентировать
оставаться:  оставаться
карта:  карта
расписание:  расписание
себя:  себя
вести:  вести
тариф:  тариф
измениться:  измениться
восторг:  восторг
наблюдение:  наблюдение
открывать:  открывать
скорректировать:  скорректировать
они:  они
управление:  управление
вверху:  вверху
указка:  указка
оптимизировать:  оптимизировать
инструмент:  инструмент
взять:  взять
установка:  установка
обеспечить:  обеспечить
кабинет:  кабинет
действие:  действие
достаточно:  достаточно
конструктор:  конструктор
москва:  москва
продукт:  продукт
превращение:  превращение
оценивать:  оценивать
забыть:  забыть
консультант:  консультант
решить:  решить
общение:  общение
интеграция:  интеграция
тыкать:  тыкать
расположить:  расположить
переход:  переход
нужный:  нужный
рука:  рука
обращение:  обращение
наводить:  наводить
подойти:  подойти
сегментировать:  сегментировать
кто:  кто
перехват:  перехват
кубик:  кубик
просто:  просто
увеличивать:  увеличивать
офис:  офис
оценка:  оценка
отчёт:  отчёт
видеть:  видеть
сталкиваться:  сталкиваться
платформа:  платформа
вызвать:  вызвать
предоставлять:  предоставлять
шаблон:  шаблон
реквизит:  реквизит
приём:  приём
подготовить:  подготовить
сеть:  сеть
объяснение:  объяснение
сохраняться:  сохраняться
магазин:  магазин
ранний:  ранний
создать:  создать
кнопка:  кнопка
оплата:  оплата
позволить:  позволить
база:  база
быстрый:  быстрый
попробовать:  попробовать
очень:  очень
март:  март
окно:  окно
пространство:  пространство
переносить:  переносить
изучать:  изучать
бот:  бот
посоветоваться:  посоветоваться
мах:  мах
рост:  рост
всплывать:  всплывать
показать:  показать
экономия:  экономия
переходить:  переходить
компьютер:  компьютер
помощь:  помощь
поле:  поле
повысить:  повысить
повышение:  повышение
заранее:  заранее
читать:  читать
мотивировать:  мотивировать
перейти:  перейти
казахстан:  казахстан
захват:  захват
добавить:  добавить
остаться:  остаться
пк:  пк
цвет:  цвет
телефон:  телефон
общаться:  общаться
изменение:  изменение
сопутствовать:  сопутствовать
глаз:  глаз
продажа:  продажа
сливаться:  сливаться
калининград:  калининград
ещё:  ещё
сетка:  сетка
где:  где
самостоятельно:  самостоятельно
оставить:  оставить
заказ:  заказ
беларусь:  беларусь
диктовка:  диктовка
полоса:  полоса
добавлять:  добавлять
собирать:  собирать
практически:  практически
февраль:  февраль
выходить:  выходить
мгновенно:  мгновенно
