стоимость:  стоимость
ещё:  ещё
взаимодействие:  взаимодействие
осуществлять:  осуществлять
задавать:  задавать
пользователь:  пользователь
преимущество:  преимущество
внедрить:  внедрить
реализовать:  реализовать
отзыв:  отзыв
стандарт:  стандарт
реализация:  реализация
бонус:  бонус
экономить:  экономить
подключиться:  подключиться
команда:  команда
такси:  такси
заказ:  заказ
стол:  стол
гарантия:  гарантия
быть:  быть
получить:  получить
выгода:  выгода
клиент:  клиент
экономия:  экономия
мы:  мы
бот:  бот
разработка:  разработка
поддержание:  поддержание
форма:  форма
погода:  погода
функция:  функция
конкурент:  конкурент
сеть:  сеть
способность:  способность
история:  история
конфиденциальность:  конфиденциальность
всё:  всё
сбор:  сбор
улучшение:  улучшение
они:  они
звонок:  звонок
платформа:  платформа
потребность:  потребность
сегодня:  сегодня
это:  это
контакт:  контакт
нажимать:  нажимать
вопрос:  вопрос
использовать:  использовать
результат:  результат
посетитель:  посетитель
успешно:  успешно
спроектировать:  спроектировать
возвращать:  возвращать
интеграция:  интеграция
ассортимент:  ассортимент
управление:  управление
частый:  частый
близость:  близость
получать:  получать
выполнить:  выполнить
статистика:  статистика
доставка:  доставка
заявка:  заявка
сравнение:  сравнение
разработать:  разработать
информация:  информация
выбор:  выбор
сервис:  сервис
угасать:  угасать
завтра:  завтра
происходить:  происходить
бронь:  бронь
проектирование:  проектирование
система:  система
протестировать:  протестировать
доработка:  доработка
сомневаться:  сомневаться
думать:  думать
увеличение:  увеличение
сообщество:  сообщество
вы:  вы
санкт-петербург:  санкт-петербург
пока:  пока
клик:  клик
заполнить:  заполнить
использование:  использование
начало:  начало
заказать:  заказать
работать:  работать
служба:  служба
возникнуть:  возникнуть
канал:  канал
остаток:  остаток
продажа:  продажа
продукт:  продукт
прямо:  прямо
интерес:  интерес
тестирование:  тестирование
впереди:  впереди
работа:  работа
нагрузка:  нагрузка
оценка:  оценка
условие:  условие
бизнес:  бизнес
число:  число
преследовать:  преследовать
аудитория:  аудитория
потребитель:  потребитель
предоставить:  предоставить
автоматизация:  автоматизация
заставлять:  заставлять
включать:  включать
кнопка:  кнопка
обработка:  обработка
время:  время
концепция:  концепция
проходить:  проходить
кто:  кто
курс:  курс
склад:  склад
оплата:  оплата
себя:  себя
хотеть:  хотеть
очередь:  очередь
не:  не
гарантировать:  гарантировать
отдельно:  отдельно
принимать:  принимать
возможность:  возможность
лояльность:  лояльность
выдерживать:  выдерживать
скачивать:  скачивать
просмотр:  просмотр
разрабатывать:  разрабатывать
курьер:  курьер
практически:  практически
становиться:  становиться
три:  три
внедрение:  внедрение
связь:  связь
удобство:  удобство
способный:  способный
нужно:  нужно
деньга:  деньга
цена:  цена
пример:  пример
сделать:  сделать
имитация:  имитация
прогноз:  прогноз
задача:  задача
билет:  билет
продвигать:  продвигать
секунда:  секунда
давать:  давать
предоставляться:  предоставляться
специально:  специально
год:  год
качество:  качество
яндекс:  яндекс
общение:  общение
проект:  проект
поддержка:  поддержка
доля:  доля
запуск:  запуск
отель:  отель
месяц:  месяц
товар:  товар
просто:  просто
информирование:  информирование
средство:  средство
технология:  технология
он:  он
работоспособность:  работоспособность
можно:  можно
решение:  решение
вариант:  вариант
образ:  образ
только:  только
заменить:  заменить
автоматически:  автоматически
спасибо:  спасибо
проблема:  проблема
подключение:  подключение
отслеживание:  отслеживание
совершать:  совершать
бронирование:  бронирование
компания:  компания
финансы:  финансы
дать:  дать
человек:  человек
встроить:  встроить
многое:  многое
алиса:  алиса
легко:  легко
оформление:  оформление
специалист:  специалист
воспользоваться:  воспользоваться
