адаптировать:  адаптировать
обеспечение:  обеспечение
профессионализм:  профессионализм
специалист:  специалист
совместно:  совместно
встроить:  встроить
использовать:  использовать
сотрудничество:  сотрудничество
реагировать:  реагировать
использование:  использование
помочь:  помочь
ответственность:  ответственность
свидетельство:  свидетельство
подписываться:  подписываться
оборудование:  оборудование
автоматизация:  автоматизация
вход:  вход
оформить:  оформить
отметить:  отметить
остаться:  остаться
служба:  служба
вода:  вода
связь:  связь
удобно:  удобно
продукт:  продукт
настройка:  настройка
срабатывать:  срабатывать
получить:  получить
кладовщик:  кладовщик
легпром:  легпром
импорт:  импорт
день:  день
количество:  количество
терминал:  терминал
попробовать:  попробовать
внедрение:  внедрение
область:  область
подпись:  подпись
журнал:  журнал
интеграция:  интеграция
доступно:  доступно
программа:  программа
мы:  мы
хотеться:  хотеться
готовый:  готовый
отзывчивость:  отзывчивость
ввод:  ввод
функционал:  функционал
вопрос:  вопрос
оборот:  оборот
нет:  нет
выгрузка:  выгрузка
маркировка:  маркировка
релиз:  релиз
возникновение:  возникновение
вывод:  вывод
разграничение:  разграничение
максимально:  максимально
знание:  знание
сотрудник:  сотрудник
преимущество:  преимущество
автоматически:  автоматически
карточка:  карточка
заказать:  заказать
признательность:  признательность
сбор:  сбор
необходимый:  необходимый
довольный:  довольный
знак:  знак
работа:  работа
сколково:  сколково
всё:  всё
решение:  решение
выразить:  выразить
вы:  вы
система:  система
обувь:  обувь
период:  период
легко:  легко
случай:  случай
данные:  данные
подписывать:  подписывать
процесс:  процесс
код:  код
открывать:  открывать
заходить:  заходить
мануал:  мануал
выбрать:  выбрать
сделать:  сделать
вента:  вента
проблема:  проблема
обратиться:  обратиться
бухгалтер:  бухгалтер
проводить:  проводить
печать:  печать
повредить:  повредить
быстро:  быстро
организация:  организация
статус:  статус
есть:  есть
нужно:  нужно
позволять:  позволять
работать:  работать
сопровождение:  сопровождение
только:  только
планшет:  планшет
цой:  цой
участник:  участник
выполнить:  выполнить
поиск:  поиск
вперёд:  вперёд
документ:  документ
рамка:  рамка
поддерживать:  поддерживать
это:  это
бизнес:  бизнес
доступ:  доступ
персонал:  персонал
юридически:  юридически
ответ:  ответ
бесплатно:  бесплатно
сканировать:  сканировать
оперативно:  оперативно
бельё:  бельё
товар:  товар
синхронизировать:  синхронизировать
министерство:  министерство
сканер:  сканер
категория:  категория
улучшение:  улучшение
начаться:  начаться
сайт:  сайт
лицензия:  лицензия
связать:  связать
назад:  назад
благодарить:  благодарить
секунда:  секунда
управление:  управление
ответить:  ответить
подробный:  подробный
ооо:  ооо
внимательный:  внимательный
операция:  операция
введение:  введение
успешно:  успешно
благодарный:  благодарный
блог:  блог
коллега:  коллега
хранилище:  хранилище
он:  он
россия:  россия
спасибо:  спасибо
смартфон:  смартфон
задача:  задача
обработка:  обработка
звонок:  звонок
прямо:  прямо
время:  время
скачать:  скачать
политика:  политика
отвечать:  отвечать
включать:  включать
этикетка:  этикетка
телефон:  телефон
сервис:  сервис
обращение:  обращение
гранд:  гранд
большой:  большой
карта:  карта
интегрировать:  интегрировать
себя:  себя
право:  право
каталог:  каталог
они:  они
рынок:  рынок
можно:  можно
несколько:  несколько
прекрасно:  прекрасно
бы:  бы
рф:  рф
ассоциация:  ассоциация
делиться:  делиться
фнс:  фнс
проконсультировать:  проконсультировать
узнать:  узнать
материал:  материал
волна:  волна
действие:  действие
разработчик:  разработчик
ограничение:  ограничение
достаточно:  достаточно
конструктор:  конструктор
надеяться:  надеяться
получение:  получение
зарегистрировать:  зарегистрировать
формироваться:  формироваться
считать:  считать
поддержка:  поддержка
просто:  просто
решить:  решить
необходимость:  необходимость
получиться:  получиться
камера:  камера
фиксироваться:  фиксироваться
учитывать:  учитывать
зависимость:  зависимость
закон:  закон
ип:  ип
регистрация:  регистрация
запись:  запись
компания:  компания
сказать:  сказать
письмо:  письмо
доступный:  доступный
компьютер:  компьютер
закупать:  закупать
очень:  очень
принцип:  принцип
продукция:  продукция
интерфейс:  интерфейс
перейти:  перейти
партия:  партия
создание:  создание
оставить:  оставить
разделение:  разделение
сергей:  сергей
не:  не
продажа:  продажа
заявка:  заявка
коллектив:  коллектив
предложить:  предложить
предоставить:  предоставить
обязательно:  обязательно
кабинет:  кабинет
окно:  окно
быть:  быть
гусейнов:  гусейнов
сканирование:  сканирование
ресурс:  ресурс
хотеть:  хотеть
клиент:  клиент
партнёр:  партнёр
находить:  находить
вызвать:  вызвать
цб:  цб
делать:  делать
передаваться:  передаваться
комплектоваться:  комплектоваться
лёгкость:  лёгкость
услуга:  услуга
помощь:  помощь
согласный:  согласный
консультация:  консультация
заказ:  заказ
показать:  показать
контакт:  контакт
подготовить:  подготовить
отсутствие:  отсутствие
функция:  функция
база:  база
желать:  желать
являться:  являться
отзыв:  отзыв
звонить:  звонить
членство:  членство
изменение:  изменение
фз:  фз
одежда:  одежда
