акция:  акция
обеспечение:  обеспечение
супермаркет:  супермаркет
помогать:  помогать
компания:  компания
дом:  дом
распознавание:  распознавание
удобство:  удобство
режим:  режим
разработка:  разработка
использование:  использование
правило:  правило
торговля:  торговля
оборудование:  оборудование
работать:  работать
софт:  софт
автоматизация:  автоматизация
подбор:  подбор
фастфуд:  фастфуд
продукт:  продукт
демонстрация:  демонстрация
политика:  политика
весы:  весы
остаться:  остаться
интернет:  интернет
сервис:  сервис
настройка:  настройка
кассир:  кассир
представить:  представить
день:  день
фонд:  фонд
количество:  количество
защитить:  защитить
увеличение:  увеличение
сэкономить:  сэкономить
кофейня:  кофейня
критерий:  критерий
магазин:  магазин
мы:  мы
создавать:  создавать
она:  она
покупатель:  покупатель
подбираться:  подбираться
ассортимент:  ассортимент
большой:  большой
эффективность:  эффективность
специалист:  специалист
автоматизировать:  автоматизировать
выводить:  выводить
учёт:  учёт
база:  база
точка:  точка
прозрачность:  прозрачность
хватать:  хватать
самообслуживание:  самообслуживание
создание:  создание
развитие:  развитие
избавиться:  избавиться
подключать:  подключать
телефон:  телефон
контроль:  контроль
система:  система
кто:  кто
происходить:  происходить
работа:  работа
интерфейс:  интерфейс
всё:  всё
хамелеон:  хамелеон
вы:  вы
стать:  стать
именно:  именно
флагман:  флагман
программа:  программа
набирать:  набирать
процесс:  процесс
подход:  подход
лишь:  лишь
касса:  касса
сеть:  сеть
плод:  плод
это:  это
принтер:  принтер
получить:  получить
быстро:  быстро
повышать:  повышать
запас:  запас
есть:  есть
позволять:  позволять
остаток:  остаток
улучшать:  улучшать
только:  только
планшет:  планшет
склад:  склад
подобрать:  подобрать
незамедлительно:  незамедлительно
более:  более
монета:  монета
регистратор:  регистратор
быть:  быть
конкурировать:  конкурировать
мечтать:  мечтать
итог:  итог
реалия:  реалия
бонус:  бонус
бизнес:  бизнес
давать:  давать
увидеть:  увидеть
чек:  чек
персонал:  персонал
что:  что
валюта:  валюта
конфиденциальность:  конфиденциальность
отслеживать:  отслеживать
звонить:  звонить
киоск:  киоск
выбор:  выбор
увеличивать:  увеличивать
место:  место
штрих:  штрих
файл:  файл
отвечать:  отвечать
обеспечивать:  обеспечивать
подбирать:  подбирать
качество:  качество
я:  я
украина:  украина
корзина:  корзина
вакансия:  вакансия
столовая:  столовая
назад:  назад
интуитивно:  интуитивно
приём:  приём
дать:  дать
оптимизировать:  оптимизировать
стоить:  стоить
подробный:  подробный
позвонить:  позвонить
деятельность:  деятельность
зона:  зона
команда:  команда
гипермаркет:  гипермаркет
условие:  условие
успешно:  успешно
контакт:  контакт
обучение:  обучение
позволить:  позволить
поиск:  поиск
постоянно:  постоянно
год:  год
характеристика:  характеристика
зал:  зал
задумываться:  задумываться
внедрение:  внедрение
передача:  передача
пользование:  пользование
перезагрузка:  перезагрузка
пользоваться:  пользоваться
ящик:  ящик
обслуживание:  обслуживание
получать:  получать
прибыль:  прибыль
свободно:  свободно
тип:  тип
заведение:  заведение
распространение:  распространение
время:  время
помощник:  помощник
микс:  микс
товарооборот:  товарооборот
чековый:  чековый
возможность:  возможность
купить:  купить
останавливаться:  останавливаться
преимущество:  преимущество
этикетка:  этикетка
документооборот:  документооборот
доверять:  доверять
собственник:  собственник
комплекс:  комплекс
себя:  себя
выдача:  выдача
повышение:  повышение
взвешивание:  взвешивание
среднее:  среднее
платёж:  платёж
производительность:  производительность
модуль:  модуль
продуктивность:  продуктивность
начинать:  начинать
избежать:  избежать
они:  они
управление:  управление
доступ:  доступ
представлять:  представлять
введение:  введение
настраивать:  настраивать
павильон:  павильон
инструмент:  инструмент
фиксировать:  фиксировать
продавец:  продавец
лицо:  лицо
ни:  ни
поставлять:  поставлять
аптека:  аптека
понимание:  понимание
действие:  действие
право:  право
конструктор:  конструктор
отправить:  отправить
аппарат:  аппарат
требовать:  требовать
штрихкод:  штрихкод
задача:  задача
поддержка:  поддержка
блог:  блог
видео:  видео
необходимость:  необходимость
инструкция:  инструкция
интеграция:  интеграция
аналитика:  аналитика
оснащение:  оснащение
салон:  салон
подготовить:  подготовить
сотрудник:  сотрудник
решение:  решение
сегмент:  сегмент
подключение:  подключение
просто:  просто
клиент:  клиент
владелец:  владелец
экономия:  экономия
способ:  способ
доказательство:  доказательство
предоставлять:  предоставлять
упрощать:  упрощать
отмечать:  отмечать
приобретение:  приобретение
устареть:  устареть
успех:  успех
код:  код
простота:  простота
товар:  товар
звонок:  звонок
монитор:  монитор
не:  не
развивать:  развивать
заявка:  заявка
невозможно:  невозможно
инновация:  инновация
сканер:  сканер
прирост:  прирост
техника:  техника
рост:  рост
обновление:  обновление
средство:  средство
ограничиваться:  ограничиваться
продукция:  продукция
сфера:  сфера
отрасль:  отрасль
повысить:  повысить
стойка:  стойка
затрата:  затрата
разгружать:  разгружать
лидер:  лидер
продажа:  продажа
требование:  требование
появиться:  появиться
согласие:  согласие
событие:  событие
пк:  пк
подставка:  подставка
комплект:  комплект
лёгкость:  лёгкость
услуга:  услуга
соглашаться:  соглашаться
стандарт:  стандарт
связь:  связь
оборот:  оборот
деньга:  деньга
самостоятельно:  самостоятельно
индикатор:  индикатор
оплата:  оплата
лояльность:  лояльность
далеко:  далеко
изучать:  изучать
труд:  труд
являться:  являться
детектор:  детектор
ещё:  ещё
заказать:  заказать
значительно:  значительно
сдача:  сдача
