услуга:  услуга
мир:  мир
решение:  решение
не:  не
ход:  ход
компания:  компания
проводиться:  проводиться
конфиденциальность:  конфиденциальность
режим:  режим
заинтересовать:  заинтересовать
поэтому:  поэтому
построение:  построение
распространяться:  распространяться
оказание:  оказание
своевременно:  своевременно
автоматизация:  автоматизация
группа:  группа
копирование:  копирование
переживать:  переживать
управление:  управление
воспользоваться:  воспользоваться
рамка:  рамка
можно:  можно
это:  это
настройка:  настройка
пользователь:  пользователь
работать:  работать
точка:  точка
широко:  широко
адаптироваться:  адаптироваться
готовый:  готовый
нога:  нога
документооборот:  документооборот
клиент:  клиент
сверка:  сверка
контракт:  контракт
фирма:  фирма
предприятие:  предприятие
мочь:  мочь
опыт:  опыт
встреча:  встреча
учёт:  учёт
торговля:  торговля
подписание:  подписание
розница:  розница
время:  время
аренда:  аренда
стандарт:  стандарт
мы:  мы
ооо:  ооо
программа:  программа
зарплата:  зарплата
сотрудник:  сотрудник
предлагать:  предлагать
стать:  стать
сопровождение:  сопровождение
поддержка:  поддержка
проведение:  проведение
идти:  идти
сохранность:  сохранность
мероприятие:  мероприятие
всё:  всё
система:  система
внедрение:  внедрение
общепит:  общепит
бухгалтерия:  бухгалтерия
обновление:  обновление
срывать:  срывать
легко:  легко
работа:  работа
