новость:  новость
система:  система
возможность:  возможность
оплата:  оплата
производитель:  производитель
кабинет:  кабинет
устанавливать:  устанавливать
версия:  версия
сторона:  сторона
функция:  функция
сайт:  сайт
преимущество:  преимущество
софт:  софт
ключ:  ключ
перейти:  перейти
причина:  причина
заказ:  заказ
совершенствование:  совершенствование
давать:  давать
скидка:  скидка
всё:  всё
цена:  цена
навредить:  навредить
исключение:  исключение
компания:  компания
пучение:  пучение
ответ:  ответ
это:  это
скачивание:  скачивание
вы:  вы
принадлежать:  принадлежать
обновление:  обновление
загрузка:  загрузка
категория:  категория
наличие:  наличие
помощь:  помощь
каталог:  каталог
праздник:  праздник
контакт:  контакт
собственность:  собственность
выпускать:  выпускать
аккаунт:  аккаунт
сбой:  сбой
база:  база
активация:  активация
авторизация:  авторизация
информация:  информация
гарант:  гарант
платёж:  платёж
трудность:  трудность
дарить:  дарить
приобрести:  приобрести
доставка:  доставка
покупка:  покупка
компьютер:  компьютер
обеспечение:  обеспечение
программа:  программа
являться:  являться
разработчик:  разработчик
регистрация:  регистрация
акция:  акция
привязка:  привязка
гарантированно:  гарантированно
оказывать:  оказывать
поддержка:  поддержка
узнать:  узнать
купить:  купить
влиять:  влиять
телефон:  телефон
данные:  данные
статья:  статья
лишь:  лишь
подписка:  подписка
мочь:  мочь
содержать:  содержать
сопровождение:  сопровождение
не:  не
право:  право
корзина:  корзина
вред:  вред
возможный:  возможный
оформить:  оформить
функционирование:  функционирование
обилие:  обилие
образ:  образ
обеспечить:  обеспечить
она:  она
сильно:  сильно
исправление:  исправление
работать:  работать
чат:  чат
нарушить:  нарушить
устранение:  устранение
хищение:  хищение
приём:  приём
установка:  установка
основа:  основа
новинка:  новинка
готовый:  готовый
уходить:  уходить
гарантировать:  гарантировать
превращаться:  превращаться
эксплуатация:  эксплуатация
организация:  организация
решение:  решение
консультация:  консультация
пользователь:  пользователь
услуга:  услуга
работоспособность:  работоспособность
служба:  служба
они:  они
только:  только
постоянно:  постоянно
ориентировать:  ориентировать
сервис:  сервис
тут:  тут
случай:  случай
знак:  знак
взломать:  взломать
наносить:  наносить
