потерять:  потерять
веб-сайт:  веб-сайт
отчёт:  отчёт
казначейство:  казначейство
повышение:  повышение
доступный:  доступный
обязанность:  обязанность
обеспечение:  обеспечение
ожидать:  ожидать
она:  она
совместно:  совместно
процесс:  процесс
погрузиться:  погрузиться
неточность:  неточность
оператор:  оператор
использовать:  использовать
доступ:  доступ
храниться:  храниться
эффективность:  эффективность
отличаться:  отличаться
позаботиться:  позаботиться
позволять:  позволять
заполнять:  заполнять
подключиться:  подключиться
режим:  режим
определить:  определить
продукт:  продукт
использование:  использование
обезличить:  обезличить
передача:  передача
получить:  получить
база:  база
доступность:  доступность
шаг:  шаг
плата:  плата
сервис:  сервис
обеспечиваться:  обеспечиваться
узнать:  узнать
автоматизация:  автоматизация
истечение:  истечение
рабочий:  рабочий
содержание:  содержание
прекратить:  прекратить
деталь:  деталь
торговля:  торговля
замена:  замена
осуществляться:  осуществляться
включать:  включать
политика:  политика
готовый:  готовый
оставить:  оставить
имя:  имя
совокупность:  совокупность
результат:  результат
находить:  находить
неприкосновенность:  неприкосновенность
документ:  документ
версия:  версия
есть:  есть
заключение:  заключение
предложить:  предложить
невозможность:  невозможность
оформляться:  оформляться
предусмотреть:  предусмотреть
принимать:  принимать
уведомление:  уведомление
разъяснение:  разъяснение
разрешить:  разрешить
настройка:  настройка
нести:  нести
оно:  оно
обсудить:  обсудить
человек:  человек
поручитель:  поручитель
связь:  связь
совершать:  совершать
стратегия:  стратегия
не:  не
услуга:  услуга
конфигурация:  конфигурация
работать:  работать
ознакомление:  ознакомление
частность:  частность
образ:  образ
строительство:  строительство
день:  день
касаться:  касаться
количество:  количество
учёт:  учёт
определиться:  определиться
бездействие:  бездействие
внедрение:  внедрение
поставщик:  поставщик
территория:  территория
область:  область
далее:  далее
строить:  строить
действие:  действие
согласие:  согласие
акт:  акт
три:  три
география:  география
отдел:  отдел
организовывать:  организовывать
выполнять:  выполнять
программист:  программист
цель:  цель
установить:  установить
точность:  точность
лицензия:  лицензия
восстановление:  восстановление
содержать:  содержать
стоимость:  стоимость
понести:  понести
нюанс:  нюанс
функционал:  функционал
эвм:  эвм
разработать:  разработать
полностью:  полностью
нет:  нет
срок:  срок
фирма:  фирма
переход:  переход
консультация:  консультация
автоматизировать:  автоматизировать
налог:  налог
специалист:  специалист
данные:  данные
запрос:  запрос
относиться:  относиться
блок:  блок
осуществлять:  осуществлять
орган:  орган
конфиденциальность:  конфиденциальность
час:  час
знание:  знание
полиция:  полиция
сотрудник:  сотрудник
собирать:  собирать
решение:  решение
основание:  основание
автоматически:  автоматически
носитель:  носитель
договор:  договор
хотеть:  хотеть
принять:  принять
актуализировать:  актуализировать
сведение:  сведение
содержаться:  содержаться
являться:  являться
определять:  определять
сбор:  сбор
распространение:  распространение
необходимый:  необходимый
способ:  способ
проверка:  проверка
удаление:  удаление
основа:  основа
прекращение:  прекращение
работа:  работа
подлежащее:  подлежащее
сохранность:  сохранность
отзыв:  отзыв
момент:  момент
запись:  запись
иван:  иван
всё:  всё
принцип:  принцип
распространять:  распространять
вы:  вы
дорабатывать:  дорабатывать
начало:  начало
система:  система
зафиксировать:  зафиксировать
сложиться:  сложиться
пользователь:  пользователь
именно:  именно
будущее:  будущее
предоставление:  предоставление
средство:  средство
сдача:  сдача
настроить:  настроить
удовлетворить:  удовлетворить
сделать:  сделать
условие:  условие
предоставить:  предоставить
кнопка:  кнопка
выявление:  выявление
реагировать:  реагировать
передать:  передать
друг:  друг
собрать:  собрать
случай:  случай
соблюдение:  соблюдение
доработка:  доработка
всегда:  всегда
представитель:  представитель
направить:  направить
хранение:  хранение
экономить:  экономить
программа:  программа
подход:  подход
зачем:  зачем
нарушаться:  нарушаться
применяться:  применяться
проблема:  проблема
подготовка:  подготовка
бизнес-процесс:  бизнес-процесс
персонал:  персонал
дать:  дать
служба:  служба
государство:  государство
качество:  качество
опубликование:  опубликование
основываться:  основываться
это:  это
наличие:  наличие
уточнение:  уточнение
категория:  категория
инфраструктура:  инфраструктура
устанавливаться:  устанавливаться
вернуть:  вернуть
организация:  организация
раскрывать:  раскрывать
информация:  информация
принятие:  принятие
начислить:  начислить
нужно:  нужно
действовать:  действовать
обучение:  обучение
сопровождение:  сопровождение
осуществление:  осуществление
обрабатываться:  обрабатываться
только:  только
запрет:  запрет
число:  число
направлять:  направлять
актуальность:  актуальность
значительно:  значительно
гарантия:  гарантия
привести:  привести
блокирование:  блокирование
темп:  темп
круг:  круг
указать:  указать
субъект:  субъект
быть:  быть
иметь:  иметь
объединить:  объединить
контроль:  контроль
рамка:  рамка
здесь:  здесь
ускорять:  ускорять
исполнение:  исполнение
пометка:  пометка
установка:  установка
директор:  директор
бизнес:  бизнес
оперативно:  оперативно
сервер:  сервер
давать:  давать
наступать:  наступать
зависание:  зависание
предоставлять:  предоставлять
характер:  характер
незаконно:  незаконно
состав:  состав
выражать:  выражать
можно:  можно
просматривать:  просматривать
говорить:  говорить
сторона:  сторона
кругом:  кругом
ответить:  ответить
основатель:  основатель
запросить:  запросить
происходить:  происходить
они:  они
защита:  защита
ит:  ит
закон:  закон
файл:  файл
улучшение:  улучшение
требование:  требование
опубликовать:  опубликовать
технология:  технология
сайт:  сайт
я:  я
ошибка:  ошибка
продолжить:  продолжить
пункт:  пункт
мочь:  мочь
фиксировать:  фиксировать
назад:  назад
заключать:  заключать
гугл:  гугл
течение:  течение
порядок:  порядок
отвечать:  отвечать
обрабатывать:  обрабатывать
указание:  указание
возможность:  возможность
иметься:  иметься
ооо:  ооо
приобретение:  приобретение
ознакомиться:  ознакомиться
полномочие:  полномочие
обеспечивать:  обеспечивать
составление:  составление
деятельность:  деятельность
накопить:  накопить
текст:  текст
вид:  вид
анализ:  анализ
продажа:  продажа
распространить:  распространить
организовать:  организовать
обработка:  обработка
перечень:  перечень
мы:  мы
он:  он
интерес:  интерес
вопрос:  вопрос
вариант:  вариант
отношение:  отношение
ответ:  ответ
федерация:  федерация
ни:  ни
прямо:  прямо
редактировать:  редактировать
ситуация:  ситуация
задача:  задача
решаться:  решаться
детально:  детально
время:  время
отрасль:  отрасль
определяться:  определяться
делопроизводство:  делопроизводство
скачать:  скачать
косвенно:  косвенно
воля:  воля
ответственность:  ответственность
отозвать:  отозвать
почта:  почта
обезличивание:  обезличивание
поле:  поле
обращение:  обращение
потеря:  потеря
должный:  должный
поэтому:  поэтому
проходить:  проходить
разделить:  разделить
себя:  себя
расчёт:  расчёт
объём:  объём
своевременно:  своевременно
безопасность:  безопасность
выгодоприобретатель:  выгодоприобретатель
администратор:  администратор
создавать:  создавать
право:  право
управление:  управление
компьютер:  компьютер
курс:  курс
красота:  красота
рынок:  рынок
браузер:  браузер
объединение:  объединение
исполнять:  исполнять
несколько:  несколько
подлежать:  подлежать
бы:  бы
соглашение:  соглашение
сеть:  сеть
перенос:  перенос
предполагаться:  предполагаться
законодательство:  законодательство
уничтожаться:  уничтожаться
исключить:  исключить
лицо:  лицо
раскрытие:  раскрытие
реализация:  реализация
регламентировать:  регламентировать
софт:  софт
затрагивать:  затрагивать
размещение:  размещение
отказаться:  отказаться
смочь:  смочь
выбрать:  выбрать
адрес:  адрес
соблюдаться:  соблюдаться
получение:  получение
гражданин:  гражданин
вручную:  вручную
соответствие:  соответствие
контролировать:  контролировать
опыт:  опыт
поддержка:  поддержка
необходимость:  необходимость
сообщать:  сообщать
бухгалтерия:  бухгалтерия
нажимать:  нажимать
соответствовать:  соответствовать
регулировать:  регулировать
аналитика:  аналитика
этап:  этап
посетитель:  посетитель
форма:  форма
бессрочно:  бессрочно
транспорт:  транспорт
зависеть:  зависеть
допускаться:  допускаться
обязать:  обязать
отсутствие:  отсутствие
праздник:  праздник
участие:  участие
кто:  кто
требовать:  требовать
метрика:  метрика
письмо:  письмо
клиент:  клиент
интересовать:  интересовать
отражаться:  отражаться
отчество:  отчество
заполнение:  заполнение
интернет:  интернет
поступление:  поступление
производство:  производство
избыточность:  избыточность
рассчитать:  рассчитать
выполнение:  выполнение
предоставляться:  предоставляться
дата:  дата
склад:  склад
власть:  власть
обязательство:  обязательство
утрата:  утрата
выходной:  выходной
эксперт:  эксперт
общественно:  общественно
регистр:  регистр
звонок:  звонок
создание:  создание
гарантировать:  гарантировать
связать:  связать
свобода:  свобода
сохранение:  сохранение
облако:  облако
невозможно:  невозможно
выдвигать:  выдвигать
ограничиваться:  ограничиваться
собираться:  собираться
локально:  локально
уничтожить:  уничтожить
метод:  метод
вправе:  вправе
составить:  составить
мера:  мера
вероятность:  вероятность
лично:  лично
получать:  получать
сложность:  сложность
журнал:  журнал
дача:  дача
написать:  написать
отчётность:  отчётность
обратиться:  обратиться
изменение:  изменение
предприятие:  предприятие
публиковать:  публиковать
инициатива:  инициатива
компания:  компания
прекращать:  прекращать
усовершенствовать:  усовершенствовать
здоровье:  здоровье
обжаловать:  обжаловать
отдельно:  отдельно
обезличиваться:  обезличиваться
взять:  взять
безвозвратно:  безвозвратно
высылать:  высылать
копия:  копия
служить:  служить
сфера:  сфера
оптимизировать:  оптимизировать
планирование:  планирование
заранее:  заранее
выполнить:  выполнить
номер:  номер
минута:  минута
производить:  производить
исключение:  исключение
сберечь:  сберечь
пк:  пк
исключать:  исключать
перенести:  перенести
держать:  держать
соглашаться:  соглашаться
разработчик:  разработчик
помощь:  помощь
просьба:  просьба
принадлежность:  принадлежность
план:  план
обнародование:  обнародование
рассмотрение:  рассмотрение
руководитель:  руководитель
регистрация:  регистрация
подготовить:  подготовить
специфика:  специфика
заявить:  заявить
направление:  направление
разрабатывать:  разрабатывать
самостоятельно:  самостоятельно
команда:  команда
контакт:  контакт
понятие:  понятие
отправлять:  отправлять
заказчик:  заказчик
прийтись:  прийтись
труд:  труд
ремонт:  ремонт
цена:  цена
позволить:  позволить
обновление:  обновление
уровень:  уровень
заказать:  заказать
подразделение:  подразделение
отправка:  отправка
убедиться:  убедиться
запускать:  запускать
озвучивать:  озвучивать
ставить:  ставить
деньга:  деньга
задействовать:  задействовать
