урок:  урок
аналитик:  аналитик
продавать:  продавать
анализ:  анализ
купить:  купить
основание:  основание
сверка:  сверка
зачем:  зачем
быть:  быть
справочник:  справочник
характеристика:  характеристика
разбор:  разбор
расчёт:  расчёт
доверенность:  доверенность
область:  область
статья:  статья
предприятие:  предприятие
услуга:  услуга
возможность:  возможность
отчёт:  отчёт
отрабатывать:  отрабатывать
клиент:  клиент
упаковка:  упаковка
эксплуатация:  эксплуатация
заканчивать:  заканчивать
создание:  создание
выплата:  выплата
поставщик:  поставщик
выбрать:  выбрать
регистрация:  регистрация
испортить:  испортить
вид:  вид
подключение:  подключение
место:  место
передача:  передача
часть:  часть
заявка:  заявка
оформить:  оформить
установка:  установка
формирование:  формирование
настройка:  настройка
помощь:  помощь
материал:  материал
учёт:  учёт
маркировать:  маркировать
скачивать:  скачивать
применение:  применение
соглашение:  соглашение
взаимозачёт:  взаимозачёт
набор:  набор
условие:  условие
цена:  цена
программа:  программа
категория:  категория
исправление:  исправление
поступление:  поступление
лицо:  лицо
меню:  меню
комитент:  комитент
работа:  работа
номенклатура:  номенклатура
не:  не
построение:  построение
конфигурация:  конфигурация
направление:  направление
доставка:  доставка
разборка:  разборка
синхронизация:  синхронизация
разрез:  разрез
получать:  получать
сборка:  сборка
приёмка:  приёмка
вариант:  вариант
что:  что
принцип:  принцип
создавать:  создавать
спецодежда:  спецодежда
продажа:  продажа
поддержание:  поддержание
расход:  расход
составлять:  составлять
выполнение:  выполнение
беларусь:  беларусь
создать:  создать
доработка:  доработка
шаблон:  шаблон
информация:  информация
разгрузка:  разгрузка
контрагент:  контрагент
курс:  курс
управление:  управление
выгода:  выгода
произвести:  произвести
себестоимость:  себестоимость
подарок:  подарок
детализация:  детализация
размещение:  размещение
день:  день
сегмент:  сегмент
обмен:  обмен
начисление:  начисление
сформировать:  сформировать
особенность:  особенность
рамка:  рамка
срок:  срок
распечатать:  распечатать
подойти:  подойти
она:  она
технология:  технология
политика:  политика
никогда:  никогда
файл:  файл
настроить:  настроить
касса:  касса
функциональность:  функциональность
сопутствовать:  сопутствовать
структура:  структура
рассмотреть:  рассмотреть
заполнение:  заполнение
лояльность:  лояльность
посвятить:  посвятить
самообслуживание:  самообслуживание
зарплата:  зарплата
хранение:  хранение
карточка:  карточка
метод:  метод
приобретение:  приобретение
накапливать:  накапливать
заведение:  заведение
распределение:  распределение
данные:  данные
карта:  карта
описать:  описать
ценообразование:  ценообразование
покупатель:  покупатель
вода:  вода
получение:  получение
серия:  серия
сертификат:  сертификат
помещение:  помещение
возникать:  возникать
торговля:  торговля
сделка:  сделка
контролироваться:  контролироваться
склад:  склад
работать:  работать
списание:  списание
органайзер:  органайзер
покупка:  покупка
ценность:  ценность
документ:  документ
ценник:  ценник
пароль:  пароль
лимит:  лимит
договор:  договор
актив:  актив
состояние:  состояние
закупка:  закупка
оформление:  оформление
делать:  делать
скачать:  скачать
корректировка:  корректировка
остаток:  остаток
контроль:  контроль
комплект:  комплект
ограничение:  ограничение
показать:  показать
детализировать:  детализировать
случай:  случай
обеспечивать:  обеспечивать
стать:  стать
мочь:  мочь
кредит:  кредит
раздел:  раздел
отлично:  отлично
стратегия:  стратегия
ведение:  ведение
использовать:  использовать
возврат:  возврат
календарь:  календарь
счёт:  счёт
иметь:  иметь
перевозка:  перевозка
механизм:  механизм
расширение:  расширение
два:  два
годность:  годность
депозит:  депозит
обзор:  обзор
начинать:  начинать
период:  период
уметь:  уметь
разобрать:  разобрать
использование:  использование
обновление:  обновление
учитывать:  учитывать
заказ:  заказ
пример:  пример
переместить:  переместить
товар:  товар
импорт:  импорт
проведение:  проведение
тип:  тип
печатать:  печатать
сторона:  сторона
перемещение:  перемещение
передавать:  передавать
излишек:  излишек
план:  план
это:  это
этикетка:  этикетка
деятельность:  деятельность
методика:  методика
достаточно:  достаточно
формировать:  формировать
обеспечение:  обеспечение
месяц:  месяц
расхождение:  расхождение
изучение:  изучение
выдача:  выдача
мониторинг:  мониторинг
образ:  образ
смотреть:  смотреть
нюанс:  нюанс
отмена:  отмена
эффективность:  эффективность
они:  они
приём:  приём
обработка:  обработка
три:  три
инвентаризация:  инвентаризация
оформляться:  оформляться
нужно:  нужно
передать:  передать
доступ:  доступ
вопрос:  вопрос
бесплатно:  бесплатно
отчётность:  отчётность
представитель:  представитель
обучение:  обучение
группа:  группа
указание:  указание
отгрузка:  отгрузка
авторизовать:  авторизовать
оприходовать:  оприходовать
расходование:  расходование
организация:  организация
скидка:  скидка
единица:  единица
опыт:  опыт
ввод:  ввод
способ:  способ
организовать:  организовать
параметр:  параметр
балл:  балл
агент:  агент
дать:  дать
только:  только
маркировка:  маркировка
макет:  макет
ввести:  ввести
почта:  почта
сайт:  сайт
магазин:  магазин
планирование:  планирование
схема:  схема
войти:  войти
квота:  квота
потребление:  потребление
пользоваться:  пользоваться
затрата:  затрата
задание:  задание
кладовая:  кладовая
авторизация:  авторизация
средство:  средство
статус:  статус
закрыть:  закрыть
составление:  составление
порог:  порог
абсолютно:  абсолютно
потребность:  потребность
задать:  задать
комиссия:  комиссия
регистрироваться:  регистрироваться
печать:  печать
кабинет:  кабинет
заём:  заём
списывать:  списывать
операция:  операция
плата:  плата
шина:  шина
здесь:  здесь
вы:  вы
иерархия:  иерархия
вывод:  вывод
вести:  вести
наценка:  наценка
показатель:  показатель
форма:  форма
он:  он
реализация:  реализация
нужный:  нужный
пользователь:  пользователь
принять:  принять
запас:  запас
сведение:  сведение
бонус:  бонус
расширить:  расширить
отразить:  отразить
рождение:  рождение
продукция:  продукция
подсистема:  подсистема
причина:  причина
тара:  тара
функционал:  функционал
оплата:  оплата
знание:  знание
ячейка:  ячейка
планировать:  планировать
сценарий:  сценарий
результат:  результат
можно:  можно
выбор:  выбор
наиболее:  наиболее
следовать:  следовать
основа:  основа
нужда:  нужда
закрытие:  закрытие
банк:  банк
применять:  применять
графика:  графика
ассортимент:  ассортимент
релиз:  релиз
партнёр:  партнёр
продемонстрировать:  продемонстрировать
подотчёт:  подотчёт
сделать:  сделать
сотрудник:  сотрудник
оформлять:  оформлять
график:  график
несколько:  несколько
сходство:  сходство
источник:  источник
совместно:  совместно
различие:  различие
