просмотр:  просмотр
редактор:  редактор
недоставать:  недоставать
возможность:  возможность
обнаружить:  обнаружить
запустить:  запустить
инструмент:  инструмент
представлять:  представлять
накладывать:  накладывать
организовать:  организовать
поддерживать:  поддерживать
есть:  есть
сортировка:  сортировка
доступ:  доступ
всё:  всё
пк:  пк
предназначить:  предназначить
это:  это
очистка:  очистка
язык:  язык
предоставлять:  предоставлять
режим:  режим
браузер:  браузер
чистка:  чистка
управлять:  управлять
избавить:  избавить
управление:  управление
пара:  пара
цель:  цель
влиять:  влиять
набор:  набор
формат:  формат
распаковка:  распаковка
создание:  создание
сжатие:  сжатие
что:  что
вызывать:  вызывать
правка:  правка
скачать:  скачать
продвинуть:  продвинуть
синхронизация:  синхронизация
диагностика:  диагностика
прокрутка:  прокрутка
гарантировать:  гарантировать
распознавание:  распознавание
данные:  данные
задача:  задача
проигрывание:  проигрывание
музыка:  музыка
лишь:  лишь
изучение:  изучение
видео:  видео
форма:  форма
аудио:  аудио
функционирование:  функционирование
решение:  решение
образ:  образ
себя:  себя
захват:  захват
исправление:  исправление
часть:  часть
винчестер:  винчестер
сборка:  сборка
обрезать:  обрезать
состав:  состав
средство:  средство
вернуть:  вернуть
программа:  программа
телефония:  телефония
безопасность:  безопасность
чистильщик:  чистильщик
добавить:  добавить
ножницы:  ножницы
оболочка:  оболочка
каталог:  каталог
представить:  представить
веб:  веб
лечение:  лечение
он:  он
конвертор:  конвертор
действовать:  действовать
страница:  страница
всегда:  всегда
версия:  версия
помогать:  помогать
взаимодействие:  взаимодействие
оживить:  оживить
наиболее:  наиболее
файл:  файл
софт:  софт
представитель:  представитель
продукт:  продукт
быть:  быть
выгрузка:  выгрузка
устранить:  устранить
клик:  клик
обновление:  обновление
доступный:  доступный
прожига:  прожига
ускорение:  ускорение
обучать:  обучать
запаковать:  запаковать
регистрация:  регистрация
превратить:  превратить
скопировать:  скопировать
защита:  защита
антивирус:  антивирус
веб-камера:  веб-камера
количество:  количество
использование:  использование
качество:  качество
флешка:  флешка
детище:  детище
записывать:  записывать
позволять:  позволять
ориентировать:  ориентировать
много:  много
прервать:  прервать
эффект:  эффект
закладка:  закладка
обеспечивать:  обеспечивать
освободить:  освободить
роутер:  роутер
воспроизвести:  воспроизвести
стать:  стать
заточить:  заточить
разбитие:  разбитие
содержать:  содержать
возможный:  возможный
практически:  практически
загрузка:  загрузка
выход:  выход
компьютер:  компьютер
делать:  делать
быстро:  быстро
запуск:  запуск
дефрагментация:  дефрагментация
раздать:  раздать
использоваться:  использоваться
веб-сёрфинг:  веб-сёрфинг
бд:  бд
пользователь:  пользователь
позволить:  позволить
можно:  можно
они:  они
проверка:  проверка
компонент:  компонент
редактирование:  редактирование
связь:  связь
оптимизировать:  оптимизировать
эмулятор:  эмулятор
оптимизация:  оптимизация
функция:  функция
архив:  архив
бесплатно:  бесплатно
регулярно:  регулярно
мы:  мы
выполнить:  выполнить
разбиение:  разбиение
прийти:  прийти
редактировать:  редактировать
работа:  работа
обрабатывать:  обрабатывать
разработчик:  разработчик
повышение:  повышение
контроль:  контроль
интерфейс:  интерфейс
информация:  информация
воспроизведение:  воспроизведение
удалить:  удалить
защитить:  защитить
точка:  точка
собрать:  собрать
являться:  являться
закачка:  закачка
мусор:  мусор
тестирование:  тестирование
эффективно:  эффективно
разгон:  разгон
менять:  менять
получать:  получать
кодек:  кодек
производительность:  производительность
входить:  входить
портал:  портал
выполнять:  выполнять
независимо:  независимо
осуществить:  осуществить
интегрироваться:  интегрироваться
описание:  описание
документ:  документ
ноутбук:  ноутбук
ремонт:  ремонт
просмотреть:  просмотреть
доступно:  доступно
устранение:  устранение
звук:  звук
справляться:  справляться
установка:  установка
основа:  основа
ящик:  ящик
предупреждать:  предупреждать
контент:  контент
аудиозапись:  аудиозапись
рядом:  рядом
запись:  запись
надельный:  надельный
увеличение:  увеличение
надёжно:  надёжно
поиск:  поиск
наделить:  наделить
сломать:  сломать
иметь:  иметь
прослушивание:  прослушивание
удаление:  удаление
получить:  получить
копирование:  копирование
угроза:  угроза
архивация:  архивация
встроить:  встроить
изменить:  изменить
реализовать:  реализовать
обеспечение:  обеспечение
сканирование:  сканирование
заменить:  заменить
система:  система
обработка:  обработка
предлагать:  предлагать
загрузить:  загрузить
библиотека:  библиотека
наличие:  наличие
кадр:  кадр
клиент:  клиент
использовать:  использовать
фотография:  фотография
помощь:  помощь
слой:  слой
скорость:  скорость
мочь:  мочь
ввод:  ввод
не:  не
чтение:  чтение
конфиденциальность:  конфиденциальность
скачивание:  скачивание
потребоваться:  потребоваться
ошибка:  ошибка
монтаж:  монтаж
диск:  диск
нужно:  нужно
она:  она
совмещать:  совмещать
создавать:  создавать
условие:  условие
раскрыть:  раскрыть
убрать:  убрать
плеер:  плеер
появляться:  появляться
создать:  создать
почта:  почта
пароль:  пароль
поддержка:  поддержка
вокал:  вокал
громкость:  громкость
лежать:  лежать
попытка:  попытка
оптимизатор:  оптимизатор
выбрать:  выбрать
отправление:  отправление
восстановление:  восстановление
