приёмка:  приёмка
потом:  потом
программист:  программист
осуществлять:  осуществлять
составить:  составить
управление:  управление
перечень:  перечень
документ:  документ
счёт-фактура:  счёт-фактура
содержать:  содержать
изменение:  изменение
требоваться:  требоваться
очень:  очень
спрос:  спрос
оплачиваться:  оплачиваться
затрата:  затрата
исходить:  исходить
квалифицировать:  квалифицировать
конфигурация:  конфигурация
обращение:  обращение
бизнес-процесс:  бизнес-процесс
часто:  часто
предлагать:  предлагать
адаптация:  адаптация
мочь:  мочь
механизм:  механизм
включить:  включить
рынок:  рынок
сервер:  сервер
быть:  быть
потребность:  потребность
сторона:  сторона
переходить:  переходить
клиент:  клиент
логика:  логика
есть:  есть
распечатываться:  распечатываться
проект:  проект
разработка:  разработка
услуга:  услуга
форма:  форма
давать:  давать
всё:  всё
внедрение:  внедрение
выбор:  выбор
пользоваться:  пользоваться
спб:  спб
обслуживание:  обслуживание
фирма:  фирма
степень:  степень
распространить:  распространить
являться:  являться
согласовать:  согласовать
развитие:  развитие
многие:  многие
платформа:  платформа
это:  это
работа:  работа
расчёт:  расчёт
автоматизировать:  автоматизировать
частное:  частное
обновление:  обновление
существовать:  существовать
нуль:  нуль
сразу:  сразу
создать:  создать
обладать:  обладать
получать:  получать
заниматься:  заниматься
сумма:  сумма
отправить:  отправить
поле:  поле
процесс:  процесс
заполнять:  заполнять
торговля:  торговля
внести:  внести
изменить:  изменить
заполнение:  заполнение
продажа:  продажа
малое:  малое
доработка:  доработка
выполнить:  выполнить
редактирование:  редактирование
заявка:  заявка
методология:  методология
список:  список
заполняться:  заполняться
формирование:  формирование
написать:  написать
вручную:  вручную
ранний:  ранний
проведение:  проведение
собирать:  собирать
оператор:  оператор
работать:  работать
оговариваться:  оговариваться
вести:  вести
нажатие:  нажатие
создание:  создание
часть:  часть
поэтому:  поэтому
предприятие:  предприятие
вызвать:  вызвать
производство:  производство
стоимость:  стоимость
производиться:  производиться
сначала:  сначала
отчёт:  отчёт
бухгалтерия:  бухгалтерия
более:  более
отвечать:  отвечать
санкт-петербург:  санкт-петербург
дорабатывать:  дорабатывать
брать:  брать
продукт:  продукт
аналитик:  аналитик
цена:  цена
сертификат:  сертификат
программа:  программа
согласие:  согласие
сотрудник:  сотрудник
этап:  этап
описание:  описание
показатель:  показатель
оценить:  оценить
хотеться:  хотеться
ведение:  ведение
требовать:  требовать
учёт:  учёт
задача:  задача
не:  не
оказывать:  оказывать
время:  время
товар:  товар
определить:  определить
бизнес:  бизнес
срок:  срок
обращаться:  обращаться
решение:  решение
выбрать:  выбрать
адрес:  адрес
отгрузка:  отгрузка
автоматизация:  автоматизация
вопрос:  вопрос
кнопка:  кнопка
сертифицировать:  сертифицировать
объём:  объём
прайс-лист:  прайс-лист
данные:  данные
сложность:  сложность
оплата:  оплата
теперь:  теперь
составление:  составление
говорить:  говорить
выявление:  выявление
решить:  решить
доработать:  доработать
результат:  результат
вызов:  вызов
я:  я
соглашаться:  соглашаться
место:  место
вы:  вы
подлежать:  подлежать
база:  база
сделать:  сделать
настройка:  настройка
объяснить:  объяснить
конфиденциальность:  конфиденциальность
осуществить:  осуществить
решать:  решать
визит:  визит
представитель:  представитель
показать:  показать
она:  она
способный:  способный
нужно:  нужно
только:  только
начисление:  начисление
ранее:  ранее
знак:  знак
счёт:  счёт
адаптировать:  адаптировать
сопровождение:  сопровождение
несколько:  несколько
реализовать:  реализовать
заказчик:  заказчик
факт:  факт
приезд:  приезд
администрирование:  администрирование
добавить:  добавить
иметься:  иметься
необходимо:  необходимо
объяснять:  объяснять
обработка:  обработка
невозможно:  невозможно
консультация:  консультация
специалист:  специалист
акт:  акт
дать:  дать
удалённый:  удалённый
бесплатный:  бесплатный
задание:  задание
знание:  знание
справочник:  справочник
отредактировать:  отредактировать
мы:  мы
позволить:  позволить
можно:  можно
момент:  момент
политика:  политика
всегда:  всегда
хороший:  хороший
удержание:  удержание
случай:  случай
компания:  компания
формироваться:  формироваться
трудоёмкость:  трудоёмкость
событие:  событие
