администратор:  администратор
способ:  способ
немного:  немного
мы:  мы
входить:  входить
взять:  взять
траст:  траст
аля:  аля
это:  это
понимать:  понимать
инвестиция:  инвестиция
заработок:  заработок
сеть:  сеть
раскрутка:  раскрутка
здесь:  здесь
мнение:  мнение
обеспечение:  обеспечение
продолжить:  продолжить
необходимо:  необходимо
находиться:  находиться
описать:  описать
файл:  файл
быть:  быть
комментарий:  комментарий
рассказ:  рассказ
средство:  средство
новость:  новость
форма:  форма
слово:  слово
источник:  источник
контент:  контент
обучение:  обучение
политика:  политика
они:  они
поле:  поле
объект:  объект
инвестор:  инвестор
ссылка:  ссылка
ввод:  ввод
возникнуть:  возникнуть
он:  он
метод:  метод
несколько:  несколько
применять:  применять
установка:  установка
читать:  читать
сегодня:  сегодня
редактирование:  редактирование
сброс:  сброс
анализ:  анализ
строить:  строить
стол:  стол
автор:  автор
загрузка:  загрузка
уровень:  уровень
я:  я
запись:  запись
куча:  куча
статья:  статья
пагинация:  пагинация
приходиться:  приходиться
зарабатывать:  зарабатывать
получение:  получение
порт:  порт
концепция:  концепция
обработка:  обработка
применение:  применение
компонент:  компонент
страница:  страница
стиль:  стиль
развернуть:  развернуть
писать:  писать
где:  где
возможность:  возможность
разработка:  разработка
суть:  суть
различать:  различать
сканирование:  сканирование
сохранение:  сохранение
игра:  игра
распространить:  распространить
часто:  часто
лишь:  лишь
скрипт:  скрипт
навигация:  навигация
программа:  программа
давно:  давно
драйвер:  драйвер
версия:  версия
не:  не
домен:  домен
база:  база
технология:  технология
система:  система
таблица:  таблица
доступность:  доступность
переключение:  переключение
админ:  админ
собирать:  собирать
многие:  многие
стоять:  стоять
браузер:  браузер
использовать:  использовать
перенос:  перенос
акция:  акция
ранее:  ранее
просто:  просто
содержать:  содержать
задаваться:  задаваться
информация:  информация
человек:  человек
бд:  бд
отключить:  отключить
сделать:  сделать
особенно:  особенно
отдельно:  отдельно
играться:  играться
почта:  почта
пк:  пк
котировка:  котировка
вопрос:  вопрос
диаграмма:  диаграмма
дерево:  дерево
говориться:  говориться
компьютер:  компьютер
рассылка:  рассылка
номер:  номер
данные:  данные
тут:  тут
индексация:  индексация
порядок:  порядок
безопасность:  безопасность
использование:  использование
сталкиваться:  сталкиваться
инвестирование:  инвестирование
термин:  термин
всё:  всё
сканер:  сканер
добавить:  добавить
оптимизация:  оптимизация
сайт:  сайт
сервер:  сервер
время:  время
стать:  стать
шлюз:  шлюз
пример:  пример
среда:  среда
политик:  политик
подключение:  подключение
структура:  структура
панель:  панель
