аккредитация:  аккредитация
центр:  центр
тэк:  тэк
оформляться:  оформляться
утилит:  утилит
регламент:  регламент
поставить:  поставить
очень:  очень
тема:  тема
торг:  торг
скачать:  скачать
подача:  подача
спасибо:  спасибо
фнс:  фнс
бесплатно:  бесплатно
сфера:  сфера
выдача:  выдача
ключ:  ключ
доступ:  доступ
банкрот:  банкрот
пройти:  пройти
сеть:  сеть
лицо:  лицо
новость:  новость
онлайн:  онлайн
комплекс:  комплекс
читать:  читать
форма:  форма
всё:  всё
хранение:  хранение
выпуск:  выпуск
получить:  получить
абсолютно:  абсолютно
момент:  момент
регистрация:  регистрация
подпись:  подпись
закупка:  закупка
имя:  имя
настроить:  настроить
это:  это
илья:  илья
получать:  получать
получение:  получение
помощь:  помощь
портал:  портал
сайт:  сайт
телефон:  телефон
сообщение:  сообщение
госуслуга:  госуслуга
управление:  управление
пять:  пять
работа:  работа
применение:  применение
вежливость:  вежливость
заявка:  заявка
кабинет:  кабинет
оформить:  оформить
компьютер:  компьютер
сервис:  сервис
подписывать:  подписывать
сертификат:  сертификат
вс:  вс
отзывчивость:  отзывчивость
карта:  карта
происходить:  происходить
документ:  документ
реализация:  реализация
оперативность:  оперативность
процесс:  процесс
сбербанк:  сбербанк
сми:  сми
драйвер:  драйвер
курс:  курс
раздел:  раздел
средство:  средство
более:  более
большинство:  большинство
раскрытие:  раскрытие
зао:  зао
работать:  работать
оказать:  оказать
программа:  программа
прямо:  прямо
город:  город
квалифицировать:  квалифицировать
точка:  точка
авторизоваться:  авторизоваться
купить:  купить
касса:  касса
внесение:  внесение
регистратор:  регистратор
связать:  связать
оставить:  оставить
специализировать:  специализировать
гражданин:  гражданин
изменение:  изменение
теперь:  теперь
доверие:  доверие
вопрос:  вопрос
забыть:  забыть
имущество:  имущество
дать:  дать
не:  не
оперативно:  оперативно
узнать:  узнать
вы:  вы
конкурс:  конкурс
июль:  июль
аста:  аста
далёкий:  далёкий
ошибка:  ошибка
вид:  вид
где:  где
обзор:  обзор
она:  она
дом:  дом
меняться:  меняться
настройка:  настройка
порядок:  порядок
возникать:  возникать
специалист:  специалист
страница:  страница
звонить:  звонить
удостоверять:  удостоверять
цепочка:  цепочка
алкоголь:  алкоголь
агент:  агент
неправильно:  неправильно
год:  год
носитель:  носитель
устройство:  устройство
корректно:  корректно
прайс-лист:  прайс-лист
общение:  общение
ольга:  ольга
фз:  фз
плагин:  плагин
оператор:  оператор
руководитель:  руководитель
целое:  целое
сергей:  сергей
просто:  просто
сдача:  сдача
заказать:  заказать
представить:  представить
услуга:  услуга
шифрование:  шифрование
позволять:  позволять
решение:  решение
можно:  можно
только:  только
предприниматель:  предприниматель
нужный:  нужный
автоматизация:  автоматизация
атрибут:  атрибут
оформление:  оформление
отчётность:  отчётность
ип:  ип
устранить:  устранить
лицензия:  лицензия
компонент:  компонент
мы:  мы
минута:  минута
площадка:  площадка
компания:  компания
закон:  закон
связь:  связь
пространство:  пространство
многое:  многое
взаимодействие:  взаимодействие
кто:  кто
удобно:  удобно
