проект:  проект
они:  они
мы:  мы
узнать:  узнать
купить:  купить
неделя:  неделя
диалог:  диалог
цель:  цель
б:  б
система:  система
продукт:  продукт
партнёр:  партнёр
маршрутизация:  маршрутизация
заявка:  заявка
нанимать:  нанимать
новость:  новость
год:  год
связаться:  связаться
настроить:  настроить
экспертиза:  экспертиза
центр:  центр
команда:  команда
протестировать:  протестировать
обеспечить:  обеспечить
понятный:  понятный
портал:  портал
более:  более
задача:  задача
прерывание:  прерывание
миграция:  миграция
уточнить:  уточнить
отпуск:  отпуск
новичок:  новичок
ответ:  ответ
условие:  условие
программа:  программа
интеграция:  интеграция
разработать:  разработать
процесс:  процесс
упростить:  упростить
апгрейд:  апгрейд
не:  не
деятельность:  деятельность
навык:  навык
лицензия:  лицензия
выбор:  выбор
работа:  работа
заказчик:  заказчик
опыт:  опыт
выбрать:  выбрать
помогать:  помогать
доработка:  доработка
нажимать:  нажимать
управление:  управление
тестирование:  тестирование
срок:  срок
сервис:  сервис
производитель:  производитель
необходимость:  необходимость
сформулировать:  сформулировать
решение:  решение
решить:  решить
участник:  участник
эксперт:  эксперт
методология:  методология
человек:  человек
внедрить:  внедрить
всё:  всё
проектирование:  проектирование
компетентность:  компетентность
ставить:  ставить
ситуация:  ситуация
интегрировать:  интегрировать
расширение:  расширение
честно:  честно
закон:  закон
внедрение:  внедрение
рассылать:  рассылать
активность:  активность
освоиться:  освоиться
кончиться:  кончиться
запрос:  запрос
телефон:  телефон
тратить:  тратить
написать:  написать
материал:  материал
очередь:  очередь
тз:  тз
начать:  начать
разработка:  разработка
сообщество:  сообщество
согласуемый:  согласуемый
превратить:  превратить
состояние:  состояние
делать:  делать
удобный:  удобный
влияние:  влияние
вы:  вы
стать:  стать
клиент:  клиент
производительность:  производительность
стек:  стек
отслеживание:  отслеживание
оптимизация:  оптимизация
соответствие:  соответствие
регистрация:  регистрация
принимать:  принимать
тип:  тип
требование:  требование
подобрать:  подобрать
этаж:  этаж
статус:  статус
дать:  дать
отчётность:  отчётность
поддержка:  поддержка
точка:  точка
поддерживать:  поддерживать
участие:  участие
снизить:  снизить
перестать:  перестать
способ:  способ
потребность:  потребность
произвести:  произвести
оценка:  оценка
комната:  комната
доказать:  доказать
автоматизировать:  автоматизировать
понятно:  понятно
бизнес:  бизнес
пригласить:  пригласить
золото:  золото
трансляция:  трансляция
список:  список
сбор:  сбор
настройка:  настройка
минимизация:  минимизация
проанализировать:  проанализировать
мониторинг:  мониторинг
хостинг:  хостинг
научить:  научить
обладать:  обладать
спланировать:  спланировать
компания:  компания
подсчёт:  подсчёт
обучение:  обучение
комфорт:  комфорт
удобство:  удобство
спроектировать:  спроектировать
реализовать:  реализовать
генерация:  генерация
проблема:  проблема
кто:  кто
проведение:  проведение
прийтись:  прийтись
сила:  сила
аттестация:  аттестация
обучить:  обучить
хотеть:  хотеть
получить:  получить
набор:  набор
подтверждение:  подтверждение
быстро:  быстро
страна:  страна
аудит:  аудит
открывать:  открывать
стоимость:  стоимость
обсудить:  обсудить
соответствовать:  соответствовать
большой:  большой
доска:  доска
провести:  провести
инцидент:  инцидент
посмотреть:  посмотреть
консалтинг:  консалтинг
бизнес-процесс:  бизнес-процесс
записать:  записать
выступать:  выступать
сотрудник:  сотрудник
консультация:  консультация
вопрос:  вопрос
версия:  версия
течение:  течение
владение:  владение
жалеть:  жалеть
справиться:  справиться
уверить:  уверить
контакт:  контакт
жизнь:  жизнь
развивать:  развивать
прикрепить:  прикрепить
администратор:  администратор
инструмент:  инструмент
делиться:  делиться
реализация:  реализация
пользователь:  пользователь
оптимизировать:  оптимизировать
эффективный:  эффективный
ожидание:  ожидание
безопасность:  безопасность
связь:  связь
делегировать:  делегировать
только:  только
оставить:  оставить
подробный:  подробный
разделить:  разделить
создать:  создать
политика:  политика
соглашаться:  соглашаться
знание:  знание
база:  база
можно:  можно
позаботиться:  позаботиться
обработать:  обработать
телефония:  телефония
помещение:  помещение
контроль:  контроль
сделать:  сделать
банк:  банк
нужный:  нужный
тормозить:  тормозить
услуга:  услуга
предоставление:  предоставление
я:  я
запуск:  запуск
вендор:  вендор
подробность:  подробность
россия:  россия
нет:  нет
затрата:  затрата
шаг:  шаг
являться:  являться
плагин:  плагин
простой:  простой
радость:  радость
