номер:  номер
участвовать:  участвовать
возможность:  возможность
преимущество:  преимущество
комфорт:  комфорт
стоить:  стоить
есть:  есть
выбор:  выбор
учёт:  учёт
доступ:  доступ
вестись:  вестись
всё:  всё
многие:  многие
структура:  структура
имя:  имя
пройти:  пройти
учитываться:  учитываться
это:  это
выполняться:  выполняться
транзакция:  транзакция
система:  система
причина:  причина
зеркало:  зеркало
вводить:  вводить
хотеть:  хотеть
полностью:  полностью
ссылка:  ссылка
сайт:  сайт
поэтому:  поэтому
вызывать:  вызывать
посетить:  посетить
проведение:  проведение
контроль:  контроль
средство:  средство
оператор:  оператор
счёт:  счёт
большинство:  большинство
скачать:  скачать
ставка:  ставка
составлять:  составлять
получиться:  получиться
норма:  норма
площадка:  площадка
ресурс:  ресурс
пользователь:  пользователь
поиск:  поиск
адаптировать:  адаптировать
частый:  частый
перевод:  перевод
помнить:  помнить
выполнение:  выполнение
попадаться:  попадаться
действовать:  действовать
часто:  часто
избежать:  избежать
вы:  вы
процедура:  процедура
способ:  способ
сделать:  сделать
мочь:  мочь
пополнение:  пополнение
несколько:  несколько
источник:  источник
рекомендоваться:  рекомендоваться
рука:  рука
получение:  получение
корректно:  корректно
устройство:  устройство
проверить:  проверить
рассмотреть:  рассмотреть
компания:  компания
всегда:  всегда
ночь:  ночь
увеличить:  увеличить
наиболее:  наиболее
администратор:  администратор
востребовать:  востребовать
перейти:  перейти
история:  история
быть:  быть
воспользоваться:  воспользоваться
быстрый:  быстрый
напрямую:  напрямую
депозит:  депозит
важно:  важно
территория:  территория
ожидание:  ожидание
зависимость:  зависимость
начинать:  начинать
недостаток:  недостаток
комиссия:  комиссия
телефон:  телефон
значок:  значок
контора:  контора
регистрация:  регистрация
шифрование:  шифрование
комбинация:  комбинация
ничто:  ничто
беспокоиться:  беспокоиться
разместить:  разместить
кликнуть:  кликнуть
сообщение:  сообщение
использование:  использование
пересмотреть:  пересмотреть
обновлять:  обновлять
мониторинг:  мониторинг
много:  много
оплата:  оплата
подключить:  подключить
достаточно:  достаточно
страница:  страница
периодически:  периодически
получать:  получать
наличие:  наличие
форма:  форма
рабочий:  рабочий
сейчас:  сейчас
портал:  портал
игрок:  игрок
входить:  входить
создать:  создать
никогда:  никогда
ничего:  ничего
возможный:  возможный
делать:  делать
зайти:  зайти
переноситься:  переноситься
практически:  практически
занять:  занять
вид:  вид
приступить:  приступить
сохраняться:  сохраняться
вход:  вход
освобождать:  освобождать
раздел:  раздел
стать:  стать
отправить:  отправить
забывать:  забывать
день:  день
дать:  дать
просто:  просто
извлекаться:  извлекаться
хорошо:  хорошо
служба:  служба
можно:  можно
постоянно:  постоянно
оказаться:  оказаться
связь:  связь
платформа:  платформа
существовать:  существовать
переплата:  переплата
блокировка:  блокировка
вариант:  вариант
команда:  команда
сеть:  сеть
новость:  новость
онлайн:  онлайн
он:  он
завсегдатай:  завсегдатай
информация:  информация
карта:  карта
прийти:  прийти
контент:  контент
ответ:  ответ
регистрироваться:  регистрироваться
они:  они
помощь:  помощь
адрес:  адрес
копия:  копия
выглядеть:  выглядеть
интерфейс:  интерфейс
чат:  чат
вывод:  вывод
представить:  представить
пароль:  пароль
подобрать:  подобрать
снять:  снять
связаться:  связаться
открыть:  открыть
являться:  являться
ввести:  ввести
поддержка:  поддержка
требовать:  требовать
продумать:  продумать
время:  время
мешать:  мешать
необходимость:  необходимость
менять:  менять
находиться:  находиться
начать:  начать
инструмент:  инструмент
стремиться:  стремиться
бонус:  бонус
оперативно:  оперативно
настоятельно:  настоятельно
предлагать:  предлагать
ряд:  ряд
логин:  логин
интернет:  интернет
доступно:  доступно
необходимо:  необходимо
запрос:  запрос
она:  она
вносить:  вносить
отображаться:  отображаться
внести:  внести
сколько:  сколько
самостоятельно:  самостоятельно
роскомнадзор:  роскомнадзор
функциональность:  функциональность
минута:  минута
легко:  легко
написать:  написать
действительно:  действительно
найти:  найти
кабинет:  кабинет
десяток:  десяток
кошелёк:  кошелёк
иметься:  иметься
попадать:  попадать
иметь:  иметь
понятный:  понятный
получить:  получить
сегодня:  сегодня
своевременно:  своевременно
сбросить:  сбросить
использовать:  использовать
покупатель:  покупатель
число:  число
список:  список
игра:  игра
веб-сайт:  веб-сайт
нет:  нет
пока:  пока
нахождение:  нахождение
повторно:  повторно
обычно:  обычно
прямо:  прямо
клиент:  клиент
состояние:  состояние
мы:  мы
отличаться:  отличаться
осуществляться:  осуществляться
порог:  порог
помочь:  помочь
не:  не
отдельно:  отдельно
деятельность:  деятельность
снятие:  снятие
подбор:  подбор
законодательство:  законодательство
час:  час
снова:  снова
потребоваться:  потребоваться
нужно:  нужно
где:  где
возникать:  возникать
войти:  войти
следовать:  следовать
рискнуть:  рискнуть
искать:  искать
создавать:  создавать
дисциплина:  дисциплина
специально:  специально
здесь:  здесь
решение:  решение
букмекер:  букмекер
обратить:  обратить
позволять:  позволять
только:  только
автоматически:  автоматически
альтернатива:  альтернатива
попробовать:  попробовать
выбрать:  выбрать
ранее:  ранее
