графика:  графика
редактор:  редактор
найти:  найти
создание:  создание
система:  система
бесплатно:  бесплатно
сайт:  сайт
текст:  текст
литература:  литература
качалка:  качалка
эмуляция:  эмуляция
обои:  обои
мы:  мы
анимация:  анимация
кодек:  кодек
блокировка:  блокировка
обслуживание:  обслуживание
драйвер:  драйвер
диагностика:  диагностика
всё:  всё
платёж:  платёж
скриншот:  скриншот
офис:  офис
стараться:  стараться
софт:  софт
дополнение:  дополнение
игра:  игра
безопасность:  безопасность
хранилище:  хранилище
файл:  файл
обеспечение:  обеспечение
база:  база
навигация:  навигация
общение:  общение
программа:  программа
пароль:  пароль
благодарить:  благодарить
ссылка:  ссылка
антивирус:  антивирус
ключ:  ключ
иконка:  иконка
скачать:  скачать
поймать:  поймать
анонимность:  анонимность
веб-камера:  веб-камера
делиться:  делиться
навигатор:  навигатор
версия:  версия
мультимедиа:  мультимедиа
раздел:  раздел
видеть:  видеть
оставить:  оставить
сеть:  сеть
компонент:  компонент
реклама:  реклама
читалка:  читалка
разработчик:  разработчик
лишь:  лишь
стол:  стол
рабочий:  рабочий
портал:  портал
карта:  карта
не:  не
попутно:  попутно
активатор:  активатор
возможность:  возможность
раскладка:  раскладка
публиковаться:  публиковаться
вы:  вы
сервер:  сервер
просмотр:  просмотр
пополняться:  пополняться
юмор:  юмор
радио:  радио
настройка:  настройка
скачивание:  скачивание
программирование:  программирование
администрирование:  администрирование
документ:  документ
только:  только
собрать:  собрать
главное:  главное
ресурс:  ресурс
телефон:  телефон
проигрыватель:  проигрыватель
интернет:  интернет
загружать:  загружать
браузер:  браузер
архиватор:  архиватор
восстановление:  восстановление
где:  где
устройство:  устройство
меню:  меню
финансы:  финансы
экран:  экран
почта:  почта
пост:  пост
исключать:  исключать
качать:  качать
шифрование:  шифрование
можно:  можно
заставка:  заставка
обновляться:  обновляться
публикация:  публикация
решать:  решать
постоянно:  постоянно
оформление:  оформление
конвертация:  конвертация
конвертер:  конвертер
диск:  диск
подгрузить:  подгрузить
написать:  написать
случай:  случай
захват:  захват
хотеть:  хотеть
