новость:  новость
заказать:  заказать
комплексно:  комплексно
действие:  действие
затрагивать:  затрагивать
подразделение:  подразделение
достигнуть:  достигнуть
сертификат:  сертификат
оптимизация:  оптимизация
увеличение:  увеличение
консалтинг:  консалтинг
руководство:  руководство
заявка:  заявка
бизнес-процесс:  бизнес-процесс
готовый:  готовый
купить:  купить
сайт:  сайт
поиск:  поиск
срок:  срок
команда:  команда
сотрудник:  сотрудник
отдел:  отдел
рынок:  рынок
персонал:  персонал
прилететь:  прилететь
заинтересовать:  заинтересовать
аудит:  аудит
кейс:  кейс
эффективность:  эффективность
услуга:  услуга
всё:  всё
информация:  информация
измерение:  измерение
стать:  стать
абсолютно:  абсолютно
история:  история
иметься:  иметься
источник:  источник
развитие:  развитие
звонок:  звонок
ещё:  ещё
пора:  пора
риска:  риска
блог:  блог
это:  это
вы:  вы
штат:  штат
проблема:  проблема
рост:  рост
использовать:  использовать
клиент:  клиент
грамотно:  грамотно
результат:  результат
повышение:  повышение
поддержка:  поддержка
процесс:  процесс
объединять:  объединять
кто-то:  кто-то
заниматься:  заниматься
контакт:  контакт
разработка:  разработка
продажа:  продажа
цель:  цель
усилие:  усилие
выручка:  выручка
критически:  критически
организация:  организация
сотрудничество:  сотрудничество
месяц:  месяц
случай:  случай
сократить:  сократить
найти:  найти
способный:  способный
доработка:  доработка
билет:  билет
помогать:  помогать
количество:  количество
запустить:  запустить
система:  система
инвестиция:  инвестиция
интеграция:  интеграция
компания:  компания
точка:  точка
сфера:  сфера
реклама:  реклама
партнёр:  партнёр
прямо:  прямо
добиваться:  добиваться
выбирать:  выбирать
оценить:  оценить
назад:  назад
вносить:  вносить
работа:  работа
нуль:  нуль
достаточно:  достаточно
внедрение:  внедрение
узнать:  узнать
мы:  мы
систематизация:  систематизация
ведение:  ведение
провести:  провести
автоматизация:  автоматизация
десятка:  десятка
превращать:  превращать
подробный:  подробный
наличие:  наличие
маркетинг:  маркетинг
получать:  получать
иерархия:  иерархия
успеть:  успеть
выполнить:  выполнить
создание:  создание
высвобождать:  высвобождать
находиться:  находиться
вариант:  вариант
компетенция:  компетенция
вопрос:  вопрос
обратиться:  обратиться
консультировать:  консультировать
не:  не
статья:  статья
идеально:  идеально
деятельность:  деятельность
право:  право
избежать:  избежать
проект:  проект
оставить:  оставить
пакет:  пакет
строительство:  строительство
основать:  основать
опыт:  опыт
потребоваться:  потребоваться
ошибка:  ошибка
решать:  решать
двигатель:  двигатель
подключение:  подключение
приносить:  приносить
отрасль:  отрасль
сводить:  сводить
она:  она
настраивать:  настраивать
ремонт:  ремонт
программист:  программист
читать:  читать
внедрять:  внедрять
торговля:  торговля
быстро:  быстро
туризм:  туризм
иногда:  иногда
отзыв:  отзыв
год:  год
подобрать:  подобрать
настроить:  настроить
входить:  входить
корректно:  корректно
панацея:  панацея
показатель:  показатель
определиться:  определиться
использование:  использование
корректировка:  корректировка
расширение:  расширение
москва:  москва
быть:  быть
обучение:  обучение
отвечать:  отвечать
именно:  именно
глаз:  глаз
служба:  служба
решение:  решение
позволять:  позволять
они:  они
позволить:  позволить
проводить:  проводить
лицензия:  лицензия
хороший:  хороший
работать:  работать
вести:  вести
сопровождение:  сопровождение
увеличить:  увеличить
коммуникация:  коммуникация
кто:  кто
недвижимость:  недвижимость
