привыкнуть:  привыкнуть
метка:  метка
выполнять:  выполнять
перейти:  перейти
ряд:  ряд
безопасность:  безопасность
вкладка:  вкладка
сеть:  сеть
не:  не
экран:  экран
утилит:  утилит
новинка:  новинка
набор:  набор
материал:  материал
видеоконференция:  видеоконференция
релиз:  релиз
рубрика:  рубрика
навигация:  навигация
дата:  дата
сразу:  сразу
сказываться:  сказываться
держать:  держать
сервис:  сервис
браузер:  браузер
пакет:  пакет
совет:  совет
представить:  представить
запись:  запись
видеозвонок:  видеозвонок
версия:  версия
запретить:  запретить
скуратов:  скуратов
ссылка:  ссылка
поиск:  поиск
просмотр:  просмотр
досуг:  досуг
можно:  можно
делать:  делать
группа:  группа
я:  я
состояться:  состояться
появление:  появление
директор:  директор
рассматривать:  рассматривать
создать:  создать
система:  система
андроид:  андроид
поддерживать:  поддерживать
файл:  файл
меню:  меню
комментарий:  комментарий
готовый:  готовый
чтение:  чтение
вы:  вы
новость:  новость
автоматизировать:  автоматизировать
ввод:  ввод
навести:  навести
код:  код
пароль:  пароль
включать:  включать
офис:  офис
они:  они
сайт:  сайт
коммуникация:  коммуникация
источник:  источник
стол:  стол
книга:  книга
группировка:  группировка
содержимое:  содержимое
автор:  автор
разработчик:  разработчик
запуск:  запуск
подменить:  подменить
обладать:  обладать
сообщить:  сообщить
звонок:  звонок
порядок:  порядок
управление:  управление
продолжить:  продолжить
связь:  связь
использование:  использование
звук:  звук
ярлык:  ярлык
клавиатура:  клавиатура
функциональность:  функциональность
много:  много
кошелёк:  кошелёк
кто:  кто
работать:  работать
синхронизация:  синхронизация
способ:  способ
технология:  технология
быть:  быть
работа:  работа
контакт:  контакт
интерфейс:  интерфейс
стиль:  стиль
вид:  вид
вибрация:  вибрация
помогать:  помогать
жизнь:  жизнь
внести:  внести
конвертирование:  конвертирование
появиться:  появиться
закрыть:  закрыть
фёдор:  фёдор
сообщение:  сообщение
сторонник:  сторонник
недавно:  недавно
время:  время
всегда:  всегда
коллекция:  коллекция
