возврат:  возврат
доставка:  доставка
комплектующие:  комплектующие
интерфейс:  интерфейс
видеонаблюдение:  видеонаблюдение
комплект:  комплект
готовый:  готовый
карта:  карта
кабинет:  кабинет
оплата:  оплата
инструмент:  инструмент
конверт:  конверт
чистить:  чистить
моноблок:  моноблок
являться:  являться
передача:  передача
продавать:  продавать
коммутатор:  коммутатор
преимущество:  преимущество
видеосигнал:  видеосигнал
выдача:  выдача
сервер:  сервер
оборудование:  оборудование
рынок:  рынок
накопитель:  накопитель
периферия:  периферия
запчасть:  запчасть
дата-центр:  дата-центр
мы:  мы
ассортимент:  ассортимент
связь:  связь
услуга:  услуга
доступ:  доступ
рада:  рада
электроника:  электроника
штрихкод:  штрихкод
что-то:  что-то
блок:  блок
подробный:  подробный
удлинитель:  удлинитель
оргтехника:  оргтехника
ооо:  ооо
платформа:  платформа
переключатель:  переключатель
интернет-магазин:  интернет-магазин
поставлять:  поставлять
вы:  вы
видеокарта:  видеокарта
печать:  печать
телефон:  телефон
кабель:  кабель
стараться:  стараться
каталог:  каталог
панель:  панель
торговля:  торговля
роутер:  роутер
покупатель:  покупатель
модем:  модем
черта:  черта
иметь:  иметь
компьютер:  компьютер
хранилище:  хранилище
компания:  компания
контроллер:  контроллер
система:  система
картридж:  картридж
способ:  способ
информация:  информация
планшет:  планшет
дигитайзер:  дигитайзер
материал:  материал
обеспечение:  обеспечение
центр:  центр
носитель:  носитель
переходник:  переходник
предлагать:  предлагать
найти:  найти
день:  день
партнёр:  партнёр
создать:  создать
корпус:  корпус
стример:  стример
продукт:  продукт
чип:  чип
контакт:  контакт
коврик:  коврик
плата:  плата
приобрести:  приобрести
гарнитур:  гарнитур
средство:  средство
полка:  полка
принадлежность:  принадлежность
веб-камера:  веб-камера
чехол:  чехол
фасовка:  фасовка
подставка:  подставка
город:  город
поэтому:  поэтому
точка:  точка
сканер:  сканер
мультиплексор:  мультиплексор
стол:  стол
предприятие:  предприятие
статья:  статья
антенна:  антенна
привод:  привод
приветствовать:  приветствовать
помощь:  помощь
ноутбук:  ноутбук
фирма:  фирма
упаковка:  упаковка
обслуживание:  обслуживание
специализировать:  специализировать
зарекомендовать:  зарекомендовать
распечатка:  распечатка
данные:  данные
сайт:  сайт
отлично:  отлично
акция:  акция
себя:  себя
маршрутизатор:  маршрутизатор
товар:  товар
продукция:  продукция
монтаж:  монтаж
скорость:  скорость
память:  память
диск:  диск
устанавливать:  устанавливать
не:  не
чат:  чат
расширение:  расширение
аксессуар:  аксессуар
деятельность:  деятельность
специалист:  специалист
база:  база
цена:  цена
предоставлять:  предоставлять
пополняться:  пополняться
сумка:  сумка
позвонить:  позвонить
концентратор:  концентратор
мышь:  мышь
флешка:  флешка
флеш-диск:  флеш-диск
охлаждение:  охлаждение
подключение:  подключение
документ:  документ
магазин:  магазин
аккумулятор:  аккумулятор
пообщаться:  пообщаться
часть:  часть
модуль:  модуль
источник:  источник
нетбук:  нетбук
проверить:  проверить
решение:  решение
ремонт:  ремонт
техника:  техника
сеть:  сеть
устройство:  устройство
питание:  питание
порт:  порт
чтение:  чтение
начать:  начать
ксерокопия:  ксерокопия
безопасность:  безопасность
рюкзак:  рюкзак
процессор:  процессор
кулер:  кулер
акустика:  акустика
адаптер:  адаптер
большой:  большой
только:  только
пункт:  пункт
держатель:  держатель
микрофон:  микрофон
заказ:  заказ
постоянно:  постоянно
ип:  ип
конвертер:  конвертер
многое:  многое
россия:  россия
находиться:  находиться
