благодарность:  благодарность
новость:  новость
действовать:  действовать
напиток:  напиток
компания:  компания
иллюзия:  иллюзия
управление:  управление
центр:  центр
лукас:  лукас
обслуживание:  обслуживание
оказаться:  оказаться
написать:  написать
консалтинг:  консалтинг
технология:  технология
редакция:  редакция
производитель:  производитель
найти:  найти
казначейство:  казначейство
соответствовать:  соответствовать
система:  система
гаснуть:  гаснуть
дорога:  дорога
сопровождение:  сопровождение
заказать:  заказать
концепт:  концепт
прайс-лист:  прайс-лист
рынок:  рынок
конкурс:  конкурс
переход:  переход
сеть:  сеть
цб:  цб
учёт:  учёт
фонд:  фонд
метрология:  метрология
бумага:  бумага
разработать:  разработать
решение:  решение
разработка:  разработка
услуга:  услуга
ознакомление:  ознакомление
всё:  всё
сигма:  сигма
есть:  есть
стать:  стать
задание:  задание
брокер:  брокер
подробный:  подробный
ооо:  ооо
сервер:  сервер
траст:  траст
кооператив:  кооператив
пк:  пк
сервис:  сервис
количество:  количество
работа:  работа
группа:  группа
гк:  гк
поставка:  поставка
лицензия:  лицензия
постановка:  постановка
обращение:  обращение
нажимать:  нажимать
эффективный:  эффективный
клиент:  клиент
участие:  участие
кун:  кун
опрос:  опрос
фгуп:  фгуп
способ:  способ
подсистема:  подсистема
внедрить:  внедрить
ук:  ук
поставщик:  поставщик
стандарт:  стандарт
си:  си
завод:  завод
ано:  ано
выполнить:  выполнить
гуп:  гуп
капитал:  капитал
единство:  единство
асу:  асу
холдинг:  холдинг
вентиляция:  вентиляция
платформа:  платформа
оао:  оао
дон:  дон
проектирование:  проектирование
моделирование:  моделирование
часть:  часть
документация:  документация
продукт:  продукт
конфиденциальность:  конфиденциальность
контакт:  контакт
шесть:  шесть
получить:  получить
производство:  производство
атака:  атака
процесс:  процесс
центробанк:  центробанк
отчёт:  отчёт
панель:  панель
бухгалтерия:  бухгалтерия
предлагать:  предлагать
предприятие:  предприятие
рф:  рф
вы:  вы
инвестиция:  инвестиция
нпо:  нпо
фабрика:  фабрика
цена:  цена
зао:  зао
обеспечение:  обеспечение
исаев:  исаев
концепция:  концепция
согласие:  согласие
корпорация:  корпорация
принимать:  принимать
договор:  договор
соответствие:  соответствие
оказание:  оказание
этикетка:  этикетка
выполнение:  выполнение
комплекс:  комплекс
выиграть:  выиграть
условие:  условие
внедрение:  внедрение
баск:  баск
бизнес:  бизнес
управлять:  управлять
мы:  мы
я:  я
статья:  статья
заключить:  заключить
ведение:  ведение
импорт:  импорт
задать:  задать
план:  план
телефон:  телефон
помощь:  помощь
позвонить:  позвонить
менеджмент:  менеджмент
фирма:  фирма
золото:  золото
кнопка:  кнопка
начать:  начать
данные:  данные
операция:  операция
показатель:  показатель
метод:  метод
срок:  срок
распределить:  распределить
методика:  методика
средство:  средство
николь:  николь
учреждение:  учреждение
регламентировать:  регламентировать
ввод:  ввод
гарантировать:  гарантировать
конференция:  конференция
техномаш:  техномаш
цикл:  цикл
максвелл:  максвелл
проект:  проект
база:  база
организация:  организация
проф:  проф
точно:  точно
попасть:  попасть
список:  список
энергетика:  энергетика
настройка:  настройка
приводиться:  приводиться
кремль:  кремль
консолидация:  консолидация
министерство:  министерство
объединить:  объединить
участник:  участник
планирование:  планирование
федерация:  федерация
пример:  пример
деньга:  деньга
объявление:  объявление
подготовка:  подготовка
принять:  принять
ао:  ао
амперсанд:  амперсанд
москва:  москва
автоматизация:  автоматизация
программа:  программа
восток:  восток
задача:  задача
отзыв:  отзыв
построение:  построение
завершить:  завершить
переходить:  переходить
обработка:  обработка
специализировать:  специализировать
анализ:  анализ
соглашение:  соглашение
партнерс:  партнерс
дополнение:  дополнение
специалист:  специалист
солитон:  солитон
микрон:  микрон
спорт:  спорт
глобально:  глобально
эксплуатация:  эксплуатация
заключение:  заключение
они:  они
давать:  давать
развитие:  развитие
можно:  можно
регион:  регион
отчётность:  отчётность
опубликовать:  опубликовать
рок-н-ролл:  рок-н-ролл
требование:  требование
ссылаться:  ссылаться
спецодежда:  спецодежда
представлять:  представлять
