показание:  показание
звонок:  звонок
цена:  цена
получить:  получить
преимущество:  преимущество
доверять:  доверять
расчёт:  расчёт
не:  не
повышение:  повышение
собственник:  собственник
проблема:  проблема
подсчёт:  подсчёт
забыть:  забыть
сайт:  сайт
запомнить:  запомнить
роль:  роль
раздел:  раздел
большой:  большой
оплатить:  оплатить
многое:  многое
диспетчер:  диспетчер
механизм:  механизм
дом:  дом
синхронизация:  синхронизация
результат:  результат
снизить:  снизить
кабинет:  кабинет
действовать:  действовать
версия:  версия
вход:  вход
демонстрация:  демонстрация
март:  март
представлять:  представлять
только:  только
совокупность:  совокупность
оставить:  оставить
право:  право
управление:  управление
курс:  курс
журнал:  журнал
ввести:  ввести
выгрузка:  выгрузка
остаться:  остаться
уведомление:  уведомление
состоять:  состоять
правительство:  правительство
видеть:  видеть
связь:  связь
что:  что
контроль:  контроль
можно:  можно
онлайн:  онлайн
исполнение:  исполнение
оплата:  оплата
условие:  условие
написать:  написать
голосование:  голосование
собираемость:  собираемость
вкладка:  вкладка
клиент:  клиент
новость:  новость
произвести:  произвести
рф:  рф
оптимизация:  оптимизация
прочее:  прочее
процент:  процент
автоматизация:  автоматизация
отправить:  отправить
ответ:  ответ
далее:  далее
система:  система
часто:  часто
перейти:  перейти
штат:  штат
вы:  вы
обновление:  обновление
затрата:  затрата
процесс:  процесс
достаточно:  достаточно
жилец:  жилец
назначение:  назначение
задавать:  задавать
управлять:  управлять
комиссия:  комиссия
принимать:  принимать
раз:  раз
ипа:  ипа
нажать:  нажать
сократить:  сократить
номер:  номер
мочь:  мочь
код:  код
качество:  качество
минута:  минута
постановление:  постановление
счёт:  счёт
передача:  передача
организация:  организация
форма:  форма
оператор:  оператор
отвечать:  отвечать
сделать:  сделать
течение:  течение
оформление:  оформление
заявка:  заявка
нажимать:  нажимать
рука:  рука
интеграция:  интеграция
услуга:  услуга
требование:  требование
помощь:  помощь
подробный:  подробный
ознакомиться:  ознакомиться
компания:  компания
необходимо:  необходимо
платёж:  платёж
сотрудник:  сотрудник
пароль:  пароль
заказать:  заказать
себя:  себя
регистрация:  регистрация
контакт:  контакт
обучение:  обучение
настройка:  настройка
страница:  страница
решение:  решение
реестр:  реестр
начисление:  начисление
он:  он
работа:  работа
перезвонить:  перезвонить
всё:  всё
использование:  использование
ещё:  ещё
это:  это
повысить:  повысить
позволить:  позволить
разработка:  разработка
житель:  житель
обслуживание:  обслуживание
поступить:  поступить
кнопка:  кнопка
формирование:  формирование
отключение:  отключение
ук:  ук
мы:  мы
данные:  данные
исполнитель:  исполнитель
скачать:  скачать
хранение:  хранение
