компания:  компания
мы:  мы
предприятие:  предприятие
собрать:  собрать
франчайзи:  франчайзи
пользователь:  пользователь
позволять:  позволять
заявка:  заявка
профессионал:  профессионал
работа:  работа
двуязычие:  двуязычие
реализация:  реализация
учёт:  учёт
фирма:  фирма
контакт:  контакт
год:  год
бизнес:  бизнес
стандарт:  стандарт
проверить:  проверить
ответ:  ответ
обеспечивать:  обеспечивать
звонок:  звонок
вы:  вы
качество:  качество
гарантировать:  гарантировать
ирбис:  ирбис
бухгалтерия:  бухгалтерия
пройти:  пройти
знать:  знать
быть:  быть
предоставить:  предоставить
обращение:  обращение
только:  только
оставить:  оставить
подробный:  подробный
ответить:  ответить
команда:  команда
отзыв:  отзыв
предоставлять:  предоставлять
обслуживание:  обслуживание
опыт:  опыт
действовать:  действовать
цель:  цель
сфера:  сфера
автоматизация:  автоматизация
накопить:  накопить
сосредоточить:  сосредоточить
заказать:  заказать
дело:  дело
основа:  основа
создать:  создать
ресурс:  ресурс
сертификация:  сертификация
база:  база
работать:  работать
срок:  срок
сотрудник:  сотрудник
услуга:  услуга
процесс:  процесс
преимущество:  преимущество
средство:  средство
имя:  имя
остаться:  остаться
решение:  решение
постоянно:  постоянно
интерес:  интерес
технология:  технология
время:  время
готовый:  готовый
вопрос:  вопрос
выполнение:  выполнение
многие:  многие
