столь:  столь
деталь:  деталь
совсем:  совсем
интегратор:  интегратор
навигация:  навигация
необходимо:  необходимо
киберпреступность:  киберпреступность
партнёр:  партнёр
процесс:  процесс
стандарт:  стандарт
система:  система
возможность:  возможность
касперский:  касперский
выстроить:  выстроить
рынок:  рынок
внушать:  внушать
реагирование:  реагирование
поставка:  поставка
оптимизироваться:  оптимизироваться
реестр:  реестр
комплекс:  комплекс
соблюдать:  соблюдать
стоить:  стоить
публикация:  публикация
ускорить:  ускорить
есть:  есть
эффективность:  эффективность
учреждение:  учреждение
эксплуатация:  эксплуатация
сложный:  сложный
согласовать:  согласовать
всё:  всё
ооо:  ооо
он:  он
они:  они
пионер:  пионер
ещё:  ещё
имя:  имя
актив:  актив
игрок:  игрок
это:  это
гк:  гк
спецсвязь:  спецсвязь
замечание:  замечание
труд:  труд
награда:  награда
портфель:  портфель
недавно:  недавно
конкурс:  конкурс
банк:  банк
интегрировать:  интегрировать
защита:  защита
наличие:  наличие
потому:  потому
теперь:  теперь
подсистема:  подсистема
работа:  работа
интеграция:  интеграция
заполнение:  заполнение
получать:  получать
управление:  управление
резидент:  резидент
победа:  победа
объединение:  объединение
максимально:  максимально
выстраивание:  выстраивание
предпосылка:  предпосылка
заявка:  заявка
осуществляться:  осуществляться
администрация:  администрация
сервис:  сервис
ресурс:  ресурс
скорость:  скорость
данил:  данил
совершенствовать:  совершенствовать
платформа:  платформа
организация:  организация
мир:  мир
персонал:  персонал
спланировать:  спланировать
поэтому:  поэтому
качественно:  качественно
контроль:  контроль
проведение:  проведение
отдел:  отдел
фонд:  фонд
географически:  географически
инцидент:  инцидент
анализ:  анализ
правление:  правление
средство:  средство
считать:  считать
заполнить:  заполнить
большинство:  большинство
компания:  компания
сотрудничество:  сотрудничество
обработка:  обработка
наиболее:  наиболее
продукт:  продукт
исследование:  исследование
выполнение:  выполнение
задача:  задача
аба:  аба
срок:  срок
город:  город
кузнецов:  кузнецов
обогащение:  обогащение
масштаб:  масштаб
цель:  цель
привести:  привести
пользование:  пользование
функционал:  функционал
поле:  поле
лидер:  лидер
операция:  операция
данные:  данные
политика:  политика
спрос:  спрос
блог:  блог
источник:  источник
кия:  кия
экология:  экология
совершенствование:  совершенствование
гол:  гол
результат:  результат
противодействие:  противодействие
приобретать:  приобретать
предоставлять:  предоставлять
часто:  часто
иметься:  иметься
гуменников:  гуменников
деятельность:  деятельность
оксана:  оксана
избежать:  избежать
показ:  показ
защитить:  защитить
план:  план
функционирование:  функционирование
признательный:  признательный
решение:  решение
оператор:  оператор
внедрение:  внедрение
сценарий:  сценарий
министерство:  министерство
обеспечить:  обеспечить
файл:  файл
стадия:  стадия
иметь:  иметь
часть:  часть
экономика:  экономика
модуль:  модуль
первухин:  первухин
принятие:  принятие
гост:  гост
рбк:  рбк
субъект:  субъект
процедура:  процедура
автоматизация:  автоматизация
актуальность:  актуальность
выбрать:  выбрать
материал:  материал
помочь:  помочь
ввести:  ввести
проект:  проект
год:  год
доступ:  доступ
реагировать:  реагировать
рождаться:  рождаться
ставка:  ставка
вы:  вы
клиент:  клиент
илюхин:  илюхин
группа:  группа
снг:  снг
столп:  столп
журнал:  журнал
мероприятие:  мероприятие
уменьшение:  уменьшение
спорт:  спорт
пройти:  пройти
телек:  телек
роботизация:  роботизация
дом:  дом
цикл:  цикл
момент:  момент
последствие:  последствие
стремиться:  стремиться
инфраструктура:  инфраструктура
использование:  использование
состояние:  состояние
учитывать:  учитывать
председатель:  председатель
версия:  версия
фёдоров:  фёдоров
совместно:  совместно
природопользование:  природопользование
специалист:  специалист
корпорация:  корпорация
гибкость:  гибкость
владислав:  владислав
взаимодействие:  взаимодействие
мониторинг:  мониторинг
стабильно:  стабильно
доклад:  доклад
осознавать:  осознавать
разбирать:  разбирать
многократно:  многократно
запрос:  запрос
разрез:  разрез
неукоснительно:  неукоснительно
предвосхитить:  предвосхитить
контролировать:  контролировать
сергиенко:  сергиенко
сотрудник:  сотрудник
эффективный:  эффективный
смещение:  смещение
направление:  направление
составлять:  составлять
работать:  работать
исполнение:  исполнение
логика:  логика
обнаруживать:  обнаруживать
применимость:  применимость
интервью:  интервью
адаптируемость:  адаптируемость
шаг:  шаг
загрузка:  загрузка
развитие:  развитие
применение:  применение
перевести:  перевести
практика:  практика
позволить:  позволить
напрямую:  напрямую
журавлёв:  журавлёв
информатизация:  информатизация
кристина:  кристина
укрепление:  укрепление
модель:  модель
комбинат:  комбинат
развиваться:  развиваться
сделка:  сделка
приобретение:  приобретение
успешно:  успешно
михаил:  михаил
организовать:  организовать
стать:  стать
соцзащита:  соцзащита
технология:  технология
руководитель:  руководитель
принцип:  принцип
роль:  роль
тиражирование:  тиражирование
ниша:  ниша
минкомсвязи:  минкомсвязи
запись:  запись
управляемость:  управляемость
центр:  центр
выполнить:  выполнить
критически:  критически
лаборатория:  лаборатория
проводить:  проводить
выражать:  выражать
паккард:  паккард
контакт:  контакт
встраивание:  встраивание
провести:  провести
выходить:  выходить
способный:  способный
немой:  немой
весьма:  весьма
разряд:  разряд
сми:  сми
планироваться:  планироваться
эпидемия:  эпидемия
становиться:  становиться
количество:  количество
посетитель:  посетитель
подразделение:  подразделение
поступать:  поступать
представитель:  представитель
благодарный:  благодарный
обязательно:  обязательно
охватывать:  охватывать
пересмотреть:  пересмотреть
безопасность:  безопасность
согласие:  согласие
регистрация:  регистрация
расследование:  расследование
доля:  доля
решить:  решить
палата:  палата
бренд:  бренд
статус:  статус
риск:  риск
входить:  входить
повышение:  повышение
киберпреступник:  киберпреступник
угроза:  угроза
высвобождение:  высвобождение
класс:  класс
рекомендовать:  рекомендовать
позволять:  позволять
существенно:  существенно
край:  край
рекомендация:  рекомендация
мэи:  мэи
метод:  метод
территориально:  территориально
разработка:  разработка
статья:  статья
упростить:  упростить
профессионализм:  профессионализм
сейчас:  сейчас
правительство:  правительство
никитин:  никитин
заказчик:  заказчик
мо:  мо
очередь:  очередь
соглашаться:  соглашаться
показать:  показать
допускаться:  допускаться
тв:  тв
лидировать:  лидировать
фактор:  фактор
делать:  делать
понравиться:  понравиться
энергетика:  энергетика
потенциал:  потенциал
карцев:  карцев
практически:  практически
консолидация:  консолидация
занять:  занять
подключение:  подключение
вид:  вид
магистраль:  магистраль
наполнение:  наполнение
александр:  александр
находиться:  находиться
сокращение:  сокращение
тимур:  тимур
подтверждать:  подтверждать
министр:  министр
объединять:  объединять
авторизация:  авторизация
использовать:  использовать
коннектор:  коннектор
наращивание:  наращивание
влияние:  влияние
заместитель:  заместитель
предприятие:  предприятие
выпустить:  выпустить
спектр:  спектр
отзыв:  отзыв
требование:  требование
исключаться:  исключаться
вопрос:  вопрос
хотеть:  хотеть
выгода:  выгода
презентация:  презентация
день:  день
исключительно:  исключительно
гиперссылка:  гиперссылка
дать:  дать
москва:  москва
укрепить:  укрепить
наблюдаться:  наблюдаться
просто:  просто
образование:  образование
выявлять:  выявлять
почта:  почта
можно:  можно
картина:  картина
уровень:  уровень
постоянно:  постоянно
нацелить:  нацелить
солонина:  солонина
защищённость:  защищённость
выполнять:  выполнять
карьера:  карьера
связь:  связь
внедрить:  внедрить
россия:  россия
подтвердить:  подтвердить
отвечать:  отвечать
начальник:  начальник
коллега:  коллега
концентрироваться:  концентрироваться
комплексно:  комплексно
событие:  событие
затрата:  затрата
наблюдать:  наблюдать
подкаст:  подкаст
бизнес-процесс:  бизнес-процесс
новость:  новость
совет:  совет
благодарить:  благодарить
мы:  мы
согласный:  согласный
атака:  атака
кластер:  кластер
информация:  информация
среднее:  среднее
пользоваться:  пользоваться
республика:  республика
использоваться:  использоваться
несколько:  несколько
вход:  вход
команда:  команда
зависеть:  зависеть
улучшение:  улучшение
надеяться:  надеяться
интеллект:  интеллект
рука:  рука
сторона:  сторона
консоль:  консоль
пик:  пик
осуществлять:  осуществлять
малое:  малое
режим:  режим
залог:  залог
перевод:  перевод
собрание:  собрание
поляк:  поляк
внесение:  внесение
обусловливать:  обусловливать
позиция:  позиция
сотрудничать:  сотрудничать
сбербанк:  сбербанк
подпроцесс:  подпроцесс
р:  р
более:  более
ответ:  ответ
директор:  директор
обеспечивать:  обеспечивать
регулирование:  регулирование
тег:  тег
точка:  точка
государство:  государство
влиять:  влиять
институт:  институт
являться:  являться
реквизит:  реквизит
схема:  схема
соответствие:  соответствие
корреляция:  корреляция
представительство:  представительство
поддержка:  поддержка
необходимость:  необходимость
автоматизировать:  автоматизировать
подрядчик:  подрядчик
обеспечение:  обеспечение
стратегия:  стратегия
служба:  служба
сертифицировать:  сертифицировать
увидеть:  увидеть
целостность:  целостность
развивать:  развивать
история:  история
сообщить:  сообщить
подход:  подход
отрасль:  отрасль
олег:  олег
конкурировать:  конкурировать
наглядно:  наглядно
повысить:  повысить
оперативно:  оперативно
право:  право
появиться:  появиться
представить:  представить
отличаться:  отличаться
проделать:  проделать
расширить:  расширить
повышать:  повышать
доверие:  доверие
страна:  страна
сочи:  сочи
норма:  норма
счёт:  счёт
удовлетворение:  удовлетворение
ход:  ход
усовершенствовать:  усовершенствовать
отношение:  отношение
прусов:  прусов
объём:  объём
перестройка:  перестройка
речь:  речь
продолжать:  продолжать
качество:  качество
департамент:  департамент
ольга:  ольга
парник:  парник
овчинник:  овчинник
создавать:  создавать
роман:  роман
благодарность:  благодарность
сколково:  сколково
сергей:  сергей
уверенный:  уверенный
именно:  именно
дублироваться:  дублироваться
функция:  функция
оптимизм:  оптимизм
объект:  объект
уязвимость:  уязвимость
признательность:  признательность
нарушение:  нарушение
удовлетворять:  удовлетворять
вполне:  вполне
тэк:  тэк
изменение:  изменение
демонстрировать:  демонстрировать
агентство:  агентство
зарегистрировать:  зарегистрировать
ит:  ит
действительно:  действительно
тренд:  тренд
кабинет:  кабинет
фокус:  фокус
очень:  очень
квалифицировать:  квалифицировать
важность:  важность
быть:  быть
сфера:  сфера
конфиденциальность:  конфиденциальность
производство:  производство
код:  код
приходиться:  приходиться
играть:  играть
смотреть:  смотреть
дмитрий:  дмитрий
содействие:  содействие
требовать:  требовать
своевременно:  своевременно
илья:  илья
интересный:  интересный
повышаться:  повышаться
офис:  офис
рассказывать:  рассказывать
отправить:  отправить
холдинг:  холдинг
смоделировать:  смоделировать
обладать:  обладать
владимир:  владимир
инструмент:  инструмент
число:  число
гуп:  гуп
асу:  асу
устанавливать:  устанавливать
оао:  оао
идти:  идти
реализация:  реализация
рф:  рф
создать:  создать
тип:  тип
заказать:  заказать
зао:  зао
телефон:  телефон
она:  она
база:  база
престиж:  престиж
сложно:  сложно
бажин:  бажин
оказывать:  оказывать
порядок:  порядок
достаточно:  достаточно
техподдержка:  техподдержка
башкортостан:  башкортостан
два:  два
сократить:  сократить
перспектива:  перспектива
заинтересованность:  заинтересованность
письмо:  письмо
помощь:  помощь
казахстан:  казахстан
наработка:  наработка
время:  время
выявление:  выявление
определить:  определить
андрей:  андрей
себя:  себя
включить:  включить
род:  род
пресс-центр:  пресс-центр
тщательно:  тщательно
мочь:  мочь
представление:  представление
не:  не
область:  область
гарантировать:  гарантировать
детектирование:  детектирование
вызывать:  вызывать
расширять:  расширять
разработать:  разработать
овчинников:  овчинников
сбор:  сбор
рассказать:  рассказать
евгений:  евгений
законодательство:  законодательство
зарекомендовать:  зарекомендовать
ошибка:  ошибка
обзор:  обзор
раз:  раз
участник:  участник
учитываться:  учитываться
подготовка:  подготовка
адаптировать:  адаптировать
ао:  ао
вовлечь:  вовлечь
сохранность:  сохранность
потребность:  потребность
формирование:  формирование
федерация:  федерация
модернизация:  модернизация
миллион:  миллион
финансы:  финансы
филиал:  филиал
предотвратить:  предотвратить
закономерно:  закономерно
централизовать:  централизовать
проектирование:  проектирование
большой:  большой
только:  только
автоматически:  автоматически
действие:  действие
создание:  создание
кто:  кто
обеспечиваться:  обеспечиваться
заботиться:  заботиться
каков:  каков
построить:  построить
