окно:  окно
листок:  листок
купить:  купить
работоспособность:  работоспособность
звонок:  звонок
она:  она
вести:  вести
надёжность:  надёжность
брянск:  брянск
не:  не
компания:  компания
представитель:  представитель
программа:  программа
заявка:  заявка
обслуживание:  обслуживание
учёт:  учёт
отчётность:  отчётность
поэтому:  поэтому
уметь:  уметь
быстро:  быстро
большой:  большой
орган:  орган
предложить:  предложить
оказание:  оказание
отдел:  отдел
сервис:  сервис
многое:  многое
узнать:  узнать
есть:  есть
позволять:  позволять
решать:  решать
ориентироваться:  ориентироваться
продукт:  продукт
он:  он
внедрение:  внедрение
сопровождение:  сопровождение
комплекс:  комплекс
всегда:  всегда
только:  только
оставить:  оставить
они:  они
установка:  установка
сотрудник:  сотрудник
более:  более
пользоваться:  пользоваться
получать:  получать
задача:  задача
уведомление:  уведомление
проблема:  проблема
рабочий:  рабочий
интернет:  интернет
связь:  связь
документ:  документ
можно:  можно
политика:  политика
это:  это
настройка:  настройка
давать:  давать
клиент:  клиент
дать:  дать
канал:  канал
участник:  участник
покупать:  покупать
область:  область
конфиденциальность:  конфиденциальность
бизнес:  бизнес
услуга:  услуга
реализация:  реализация
заключаться:  заключаться
сдача:  сдача
выгодно:  выгодно
оперативно:  оперативно
мы:  мы
учитывать:  учитывать
вы:  вы
помощь:  помощь
сдавать:  сдавать
напрямую:  напрямую
достаточно:  достаточно
стоимость:  стоимость
вопрос:  вопрос
контролировать:  контролировать
где:  где
отправить:  отправить
согласие:  согласие
предприятие:  предприятие
поддержка:  поддержка
передавать:  передавать
справиться:  справиться
опыт:  опыт
создание:  создание
насчитывать:  насчитывать
деятельность:  деятельность
пк:  пк
решить:  решить
максимально:  максимально
база:  база
выгрузка:  выгрузка
нажимать:  нажимать
соглашаться:  соглашаться
идти:  идти
решение:  решение
подробный:  подробный
тариф:  тариф
форма:  форма
гарантия:  гарантия
обновление:  обновление
выгружать:  выгружать
принимать:  принимать
сайт:  сайт
предлагать:  предлагать
малое:  малое
информация:  информация
необходимый:  необходимый
способ:  способ
просто:  просто
отправлять:  отправлять
адаптация:  адаптация
офис:  офис
обработка:  обработка
непосредственно:  непосредственно
контакт:  контакт
успешно:  успешно
работа:  работа
всё:  всё
риск:  риск
управлять:  управлять
прийтись:  прийтись
спектр:  спектр
перенести:  перенести
преимущество:  преимущество
отлично:  отлично
количество:  количество
являться:  являться
штат:  штат
качественно:  качественно
необходимо:  необходимо
момент:  момент
отправка:  отправка
прямо:  прямо
заказать:  заказать
период:  период
навстречу:  навстречу
собрать:  собрать
точка:  точка
взаимодействие:  взаимодействие
данные:  данные
аутсорсинг:  аутсорсинг
время:  время
франчайзи:  франчайзи
