внедрение:  внедрение
проект:  проект
компания:  компания
мы:  мы
бизнес:  бизнес
прайс-лист:  прайс-лист
купить:  купить
соответствие:  соответствие
заявка:  заявка
вопрос:  вопрос
характер:  характер
деятельность:  деятельность
быть:  быть
это:  это
декабрь:  декабрь
накопить:  накопить
среднее:  среднее
облако:  облако
вы:  вы
софт:  софт
поставляться:  поставляться
тэк:  тэк
учреждение:  учреждение
предприятие:  предприятие
интегрироваться:  интегрироваться
величина:  величина
решение:  решение
цена:  цена
продукт:  продукт
нацелить:  нацелить
разработать:  разработать
февраль:  февраль
телефон:  телефон
предприниматель:  предприниматель
нетрудоспособность:  нетрудоспособность
работа:  работа
связь:  связь
перечень:  перечень
новость:  новость
учёт:  учёт
качество:  качество
помощь:  помощь
контакт:  контакт
версия:  версия
обучение:  обучение
июль:  июль
выдача:  выдача
запомнить:  запомнить
релиз:  релиз
реквизит:  реквизит
описать:  описать
акция:  акция
методика:  методика
январь:  январь
сдавать:  сдавать
подписаться:  подписаться
задать:  задать
нужно:  нужно
обладать:  обладать
звонок:  звонок
мероприятие:  мероприятие
носить:  носить
сокращать:  сокращать
перейти:  перейти
пользователь:  пользователь
программа:  программа
заметка:  заметка
система:  система
внедрить:  внедрить
обязать:  обязать
партнёр:  партнёр
ноябрь:  ноябрь
отчётность:  отчётность
удалённый:  удалённый
оао:  оао
доступный:  доступный
фотогалерея:  фотогалерея
направление:  направление
сертификат:  сертификат
мрот:  мрот
конфиденциальность:  конфиденциальность
задача:  задача
материал:  материал
позволять:  позволять
листок:  листок
условие:  условие
слово:  слово
оценка:  оценка
являться:  являться
уведомление:  уведомление
сизый:  сизый
организация:  организация
вакансия:  вакансия
ссылка:  ссылка
мастер:  мастер
фирма:  фирма
платформа:  платформа
правило:  правило
фнс:  фнс
обзор:  обзор
всё:  всё
ввести:  ввести
опыт:  опыт
учитываться:  учитываться
политика:  политика
год:  год
услуга:  услуга
интеграция:  интеграция
разработка:  разработка
клиент:  клиент
комплект:  комплект
издержка:  издержка
подавать:  подавать
специализировать:  специализировать
использовать:  использовать
поддержка:  поддержка
автоматизация:  автоматизация
график:  график
статья:  статья
апгрейд:  апгрейд
не:  не
код:  код
отряд:  отряд
известно:  известно
лицензия:  лицензия
рекомендовать:  рекомендовать
регион:  регион
заказать:  заказать
сопровождение:  сопровождение
оказание:  оказание
регистрация:  регистрация
получить:  получить
далее:  далее
вариант:  вариант
апрель:  апрель
набор:  набор
налог:  налог
маркировка:  маркировка
корректность:  корректность
прошедшее:  прошедшее
выбор:  выбор
анкета:  анкета
обработка:  обработка
доход:  доход
регламент:  регламент
оформление:  оформление
бухгалтерия:  бухгалтерия
вычет:  вычет
просто:  просто
сервис:  сервис
счёт:  счёт
редакция:  редакция
выбрать:  выбрать
декларация:  декларация
сайт:  сайт
предназначить:  предназначить
компетенция:  компетенция
удобство:  удобство
адрес:  адрес
справка:  справка
стать:  стать
руководитель:  руководитель
понимание:  понимание
база:  база
труд:  труд
управление:  управление
войти:  войти
тестирование:  тестирование
линейка:  линейка
собственник:  собственник
забыть:  забыть
сотрудник:  сотрудник
отзыв:  отзыв
состав:  состав
центр:  центр
минфин:  минфин
перерегистрировать:  перерегистрировать
отдел:  отдел
промышленность:  промышленность
семинар:  семинар
данные:  данные
аккредитовать:  аккредитовать
подключиться:  подключиться
гк:  гк
развиваться:  развиваться
представить:  представить
иса:  иса
выпуск:  выпуск
потребность:  потребность
результат:  результат
место:  место
уплата:  уплата
зарегистрировать:  зарегистрировать
порядок:  порядок
курс:  курс
специализироваться:  специализироваться
бесплатно:  бесплатно
россия:  россия
бизнес-процесс:  бизнес-процесс
ооо:  ооо
применение:  применение
укладываться:  укладываться
взаимодействие:  взаимодействие
розница:  розница
технология:  технология
зарегистрироваться:  зарегистрироваться
запустить:  запустить
приборостроение:  приборостроение
оферта:  оферта
я:  я
ключ:  ключ
комментарий:  комментарий
функциональность:  функциональность
инструкция:  инструкция
лицо:  лицо
ес:  ес
