обеспечение:  обеспечение
публикация:  публикация
использование:  использование
не:  не
проект:  проект
выполнить:  выполнить
разработка:  разработка
требовать:  требовать
сервис:  сервис
вы:  вы
результат:  результат
есть:  есть
исследование:  исследование
способный:  способный
проектирование:  проектирование
сложность:  сложность
рамка:  рамка
система:  система
это:  это
цель:  цель
информация:  информация
программа:  программа
разрабатывать:  разрабатывать
внедрение:  внедрение
услуга:  услуга
адаптироваться:  адаптироваться
интеграция:  интеграция
хранение:  хранение
веб:  веб
выбрать:  выбрать
получение:  получение
полностью:  полностью
лаборатория:  лаборатория
архитектура:  архитектура
данные:  данные
концепция:  концепция
протокол:  протокол
делать:  делать
блог:  блог
работать:  работать
управление:  управление
двор:  двор
подробный:  подробный
сервер:  сервер
транспорт:  транспорт
контроль:  контроль
решение:  решение
выполнять:  выполнять
оборудование:  оборудование
направление:  направление
предприятие:  предприятие
мы:  мы
контакт:  контакт
он:  он
обмен:  обмен
специфика:  специфика
качественно:  качественно
задача:  задача
конец:  конец
сформулировать:  сформулировать
