анимация:  анимация
анализ:  анализ
обеспечение:  обеспечение
производитель:  производитель
встраивать:  встраивать
покупать:  покупать
стараться:  стараться
утилит:  утилит
софт:  софт
ознакомиться:  ознакомиться
поле:  поле
узнать:  узнать
автоматизация:  автоматизация
скоро:  скоро
принять:  принять
продукт:  продукт
многие:  многие
вход:  вход
переводчик:  переводчик
корпус:  корпус
имя:  имя
доставка:  доставка
круглосуточно:  круглосуточно
плагин:  плагин
январь:  январь
точка:  точка
успеть:  успеть
сервис:  сервис
возникнуть:  возникнуть
среда:  среда
удобно:  удобно
антивирус:  антивирус
статья:  статья
оптимизация:  оптимизация
воспользоваться:  воспользоваться
будущее:  будущее
перевод:  перевод
сапр:  сапр
согласие:  согласие
поэтому:  поэтому
магазин:  магазин
инструмент:  инструмент
мир:  мир
мы:  мы
мнёвники:  мнёвники
три:  три
сканирование:  сканирование
переход:  переход
выпустить:  выпустить
диск:  диск
вопрос:  вопрос
новинка:  новинка
эффективность:  эффективность
рассрочка:  рассрочка
отличие:  отличие
превышать:  превышать
акция:  акция
нововведение:  нововведение
визуализация:  визуализация
реклама:  реклама
создание:  создание
прогноз:  прогноз
сведение:  сведение
редактор:  редактор
вебсайт:  вебсайт
половина:  половина
телефон:  телефон
применять:  применять
ответ:  ответ
получить:  получить
удовольствие:  удовольствие
релиз:  релиз
момент:  момент
программирование:  программирование
всё:  всё
разработчик:  разработчик
вы:  вы
скорость:  скорость
именно:  именно
товар:  товар
словарь:  словарь
данные:  данные
работа:  работа
ссылка:  ссылка
поставщик:  поставщик
ноябрь:  ноябрь
регистрация:  регистрация
инфраструктура:  инфраструктура
постепенно:  постепенно
символ:  символ
информация:  информация
сталкиваться:  сталкиваться
пятница:  пятница
поставлять:  поставлять
оценка:  оценка
копирование:  копирование
приобретение:  приобретение
только:  только
опыт:  опыт
позволить:  позволить
пользоваться:  пользоваться
выгодно:  выгодно
проблема:  проблема
статус:  статус
ожидать:  ожидать
рамка:  рамка
это:  это
давать:  давать
сервер:  сервер
дом:  дом
персонал:  персонал
продукция:  продукция
выбор:  выбор
поздравлять:  поздравлять
импортозамещение:  импортозамещение
сокровищница:  сокровищница
подписаться:  подписаться
купить:  купить
документ:  документ
конфиденциальность:  конфиденциальность
платёж:  платёж
гарантия:  гарантия
графика:  графика
новость:  новость
защита:  защита
сканер:  сканер
категория:  категория
улучшение:  улучшение
полиграфия:  полиграфия
стоимость:  стоимость
обновление:  обновление
решение:  решение
разработка:  разработка
организация:  организация
сайт:  сайт
домен:  домен
предлагать:  предлагать
почему:  почему
карта:  карта
течение:  течение
интернет-магазин:  интернет-магазин
управление:  управление
станция:  станция
подробный:  подробный
программа:  программа
мониторинг:  мониторинг
сертификат:  сертификат
фио:  фио
ратовать:  ратовать
оформить:  оформить
средство:  средство
цена:  цена
партнёр:  партнёр
простой:  простой
размещение:  размещение
он:  он
год:  год
система:  система
почта:  почта
безопасность:  безопасность
россия:  россия
активно:  активно
восстановление:  восстановление
обработка:  обработка
приходиться:  приходиться
запись:  запись
фото:  фото
шт:  шт
ситуация:  ситуация
код:  код
миграция:  миграция
заказ:  заказ
проверка:  проверка
обучение:  обучение
шлюз:  шлюз
политика:  политика
являться:  являться
преимущество:  преимущество
фильтр:  фильтр
изучение:  изучение
повышение:  повышение
несколько:  несколько
право:  право
частый:  частый
вид:  вид
согласный:  согласный
каталог:  каталог
они:  они
требование:  требование
возможность:  возможность
доступ:  доступ
можно:  можно
условие:  условие
отношение:  отношение
исключить:  исключить
лицо:  лицо
сеть:  сеть
сфера:  сфера
работать:  работать
документация:  документация
перейти:  перейти
день:  день
москва:  москва
расчёт:  расчёт
пользователь:  пользователь
существенно:  существенно
учёт:  учёт
приобретать:  приобретать
видео:  видео
контроль:  контроль
трудность:  трудность
бухгалтерия:  бухгалтерия
понедельник:  понедельник
нужный:  нужный
старт:  старт
дизайн:  дизайн
кто:  кто
быть:  быть
офис:  офис
интернет:  интернет
выполнение:  выполнение
повысить:  повысить
очень:  очень
скидка:  скидка
процесс:  процесс
устройство:  устройство
программист:  программист
язык:  язык
строка:  строка
защитник:  защитник
текст:  текст
поиск:  поиск
консоль:  консоль
база:  база
стать:  стать
приобрести:  приобрести
звонок:  звонок
стартап:  стартап
внимание:  внимание
разрабатывать:  разрабатывать
не:  не
практика:  практика
настройка:  настройка
оплата:  оплата
топ:  топ
распознавание:  распознавание
март:  март
состав:  состав
архиватор:  архиватор
сделать:  сделать
получать:  получать
представитель:  представитель
онлайн:  онлайн
компания:  компания
уязвимость:  уязвимость
клиент:  клиент
подпись:  подпись
бизнес:  бизнес
компьютер:  компьютер
творчество:  творчество
минута:  минута
спектр:  спектр
файл:  файл
энциклопедия:  энциклопедия
препятствовать:  препятствовать
обзор:  обзор
выплачивать:  выплачивать
использовать:  использовать
консультант:  консультант
субд:  субд
помощь:  помощь
мультимедиа:  мультимедиа
пиратство:  пиратство
архивирование:  архивирование
время:  время
архивация:  архивация
контакт:  контакт
защищённость:  защищённость
охрана:  охрана
труд:  труд
набор:  набор
февраль:  февраль
иметь:  иметь
заказать:  заказать
число:  число
зачастую:  зачастую
значительно:  значительно
я:  я
версия:  версия
декабрь:  декабрь
