компания:  компания
мы:  мы
ранее:  ранее
купить:  купить
планировать:  планировать
подключить:  подключить
специалист:  специалист
решение:  решение
среднее:  среднее
ндс:  ндс
получить:  получить
поиск:  поиск
предприятие:  предприятие
прийтись:  прийтись
файл:  файл
продажа:  продажа
программа:  программа
долго:  долго
подробно:  подробно
вести:  вести
работа:  работа
новость:  новость
контакт:  контакт
телефон:  телефон
помощь:  помощь
вы:  вы
ввод:  ввод
задать:  задать
звонок:  звонок
вопрос:  вопрос
заполнить:  заполнить
работать:  работать
система:  система
есть:  есть
отправить:  отправить
бесплатно:  бесплатно
отчётность:  отчётность
готовый:  готовый
акция:  акция
материал:  материал
загрузка:  загрузка
продукт:  продукт
выплата:  выплата
непосредственно:  непосредственно
прийти:  прийти
период:  период
документ:  документ
день:  день
транзакция:  транзакция
правило:  правило
платформа:  платформа
гостиница:  гостиница
обработка:  обработка
создание:  создание
учить:  учить
условие:  условие
пользоваться:  пользоваться
услуга:  услуга
формат:  формат
происходить:  происходить
расчёт:  расчёт
параметр:  параметр
совместимый:  совместимый
разработка:  разработка
консультация:  консультация
статья:  статья
очень:  очень
изменить:  изменить
не:  не
быть:  быть
проф:  проф
ставка:  ставка
случай:  случай
пособие:  пособие
заказать:  заказать
поставка:  поставка
обучать:  обучать
дать:  дать
заниматься:  заниматься
реализовать:  реализовать
участок:  участок
предлагать:  предлагать
что:  что
вместе:  вместе
важно:  важно
помогать:  помогать
звонить:  звонить
ввести:  ввести
обслуживание:  обслуживание
сервис:  сервис
внедрение:  внедрение
кто:  кто
теперь:  теперь
остаток:  остаток
конфигурация:  конфигурация
думать:  думать
перенести:  перенести
контрагент:  контрагент
обеспечить:  обеспечить
установка:  установка
линейка:  линейка
номенклатура:  номенклатура
далее:  далее
дата:  дата
предназначить:  предназначить
данные:  данные
сопровождение:  сопровождение
хит:  хит
одновременно:  одновременно
сомнение:  сомнение
предварительно:  предварительно
год:  год
остаться:  остаться
ооо:  ооо
заработок:  заработок
выгрузка:  выгрузка
пробежаться:  пробежаться
скачать:  скачать
всегда:  всегда
управление:  управление
