помочь:  помочь
мы:  мы
звук:  звук
рост:  рост
магазин:  магазин
контроль:  контроль
приносить:  приносить
блог:  блог
распознавание:  распознавание
оставаться:  оставаться
решаться:  решаться
объявление:  объявление
заявка:  заявка
видеопоток:  видеопоток
достигнуть:  достигнуть
качество:  качество
контакт:  контакт
продажа:  продажа
они:  они
бизнес:  бизнес
польза:  польза
почему:  почему
вы:  вы
хорошо:  хорошо
заболевание:  заболевание
делать:  делать
человек:  человек
область:  область
рынок:  рынок
работа:  работа
проверка:  проверка
доля:  доля
идея:  идея
аналитика:  аналитика
обучение:  обучение
улучшение:  улучшение
разработка:  разработка
кол-центр:  кол-центр
прорыв:  прорыв
помощь:  помощь
оставить:  оставить
задание:  задание
фотография:  фотография
значительно:  значительно
быть:  быть
жить:  жить
только:  только
создание:  создание
команда:  команда
обработка:  обработка
исследование:  исследование
использовать:  использовать
мониторинг:  мониторинг
сфера:  сфера
идентификация:  идентификация
клиент:  клиент
несколько:  несколько
ситуация:  ситуация
партнёр:  партнёр
лицо:  лицо
автоматизация:  автоматизация
сторона:  сторона
двигатель:  двигатель
улучшить:  улучшить
здесь:  здесь
хороший:  хороший
очень:  очень
предлагать:  предлагать
опыт:  опыт
проведение:  проведение
полка:  полка
это:  это
продукт:  продукт
прогнозирование:  прогнозирование
насколько:  насколько
не:  не
случай:  случай
сейчас:  сейчас
система:  система
ну:  ну
реализовать:  реализовать
сокращение:  сокращение
сайт:  сайт
задача:  задача
вариант:  вариант
классификация:  классификация
успешность:  успешность
интеграция:  интеграция
сервис:  сервис
просто:  просто
интеллект:  интеллект
диагностика:  диагностика
товар:  товар
этап:  этап
действие:  действие
дать:  дать
работать:  работать
передать:  передать
сделать:  сделать
зрение:  зрение
эксперт:  эксперт
решение:  решение
компания:  компания
кампания:  кампания
относиться:  относиться
скоро:  скоро
преимущество:  преимущество
объект:  объект
требовать:  требовать
камера:  камера
трансформация:  трансформация
обмен:  обмен
голос:  голос
ответственно:  ответственно
данные:  данные
кто:  кто
создавать:  создавать
радио:  радио
конкурент:  конкурент
язык:  язык
дышать:  дышать
успешно:  успешно
безопасность:  безопасность
повысить:  повысить
решать:  решать
более:  более
применение:  применение
бережно:  бережно
никогда:  никогда
поиск:  поиск
знакомство:  знакомство
