рязань:  рязань
развозить:  развозить
стартап:  стартап
трекер:  трекер
телематика:  телематика
партнёр:  партнёр
изготовление:  изготовление
заявка:  заявка
система:  система
заранее:  заранее
поставка:  поставка
комплекс:  комплекс
эффективность:  эффективность
тонна:  тонна
ноль:  ноль
диспетчерская:  диспетчерская
вкупе:  вкупе
функционал:  функционал
всё:  всё
ооо:  ооо
сократить:  сократить
подарок:  подарок
это:  это
режим:  режим
топливо:  топливо
расход:  расход
теперь:  теперь
тахограф:  тахограф
интеграция:  интеграция
груз:  груз
обращение:  обращение
управление:  управление
реализация:  реализация
обучение:  обучение
новость:  новость
аграрий:  аграрий
активация:  активация
транспорт:  транспорт
вождение:  вождение
тамбов:  тамбов
месяц:  месяц
контроль:  контроль
дисциплина:  дисциплина
правильно:  правильно
оснащение:  оснащение
водитель:  водитель
компания:  компания
проезд:  проезд
вакансия:  вакансия
установка:  установка
подписаться:  подписаться
продукт:  продукт
директор:  директор
бизнес:  бизнес
город:  город
доказать:  доказать
данные:  данные
работать:  работать
подробный:  подробный
регион:  регион
посещение:  посещение
хотеть:  хотеть
нацелить:  нацелить
видео:  видео
техника:  техника
метеостанция:  метеостанция
деятельность:  деятельность
пробег:  пробег
избежать:  избежать
интегратор:  интегратор
решение:  решение
настройка:  настройка
внедрение:  внедрение
белые:  белые
пропуск:  пропуск
цифра:  цифра
автопарк:  автопарк
проект:  проект
находить:  находить
давать:  давать
накрутка:  накрутка
результат:  результат
год:  год
обработка:  обработка
блок:  блок
клиент:  клиент
группа:  группа
камаз:  камаз
нормирование:  нормирование
генерироваться:  генерироваться
доступ:  доступ
видеонаблюдение:  видеонаблюдение
диспетчеризация:  диспетчеризация
перерасход:  перерасход
всегда:  всегда
заправка:  заправка
находиться:  находиться
он:  он
газель:  газель
сокращать:  сокращать
модуль:  модуль
меркурий:  меркурий
мониторинг:  мониторинг
ответить:  ответить
тест:  тест
передача:  передача
сайт:  сайт
запустить:  запустить
зил:  зил
перейти:  перейти
сотрудник:  сотрудник
период:  период
специфика:  специфика
зарекомендовать:  зарекомендовать
аудит:  аудит
автомобиль:  автомобиль
урожай:  урожай
тип:  тип
карта:  карта
звонок:  звонок
разблокировка:  разблокировка
байка:  байка
согласный:  согласный
автобус:  автобус
белгород:  белгород
факт:  факт
рубль:  рубль
авторизация:  авторизация
автоматизировать:  автоматизировать
контакт:  контакт
видеоролик:  видеоролик
урожайность:  урожайность
сэкономить:  сэкономить
вы:  вы
курск:  курск
хозяйство:  хозяйство
предполагать:  предполагать
снизить:  снизить
аналитика:  аналитика
не:  не
статус:  статус
статья:  статья
содержание:  содержание
студент:  студент
пройти:  пройти
рекомендовать:  рекомендовать
два:  два
осуществление:  осуществление
внесение:  внесение
орёл:  орёл
вездеход:  вездеход
сейчас:  сейчас
пятно:  пятно
написать:  написать
срыв:  срыв
цепочка:  цепочка
ежедневно:  ежедневно
транспортировка:  транспортировка
экономия:  экономия
добиться:  добиться
четыре:  четыре
вести:  вести
датчик:  датчик
внедрять:  внедрять
следить:  следить
воронеж:  воронеж
включать:  включать
ремонт:  ремонт
искать:  искать
предприятие:  предприятие
отзыв:  отзыв
жизнь:  жизнь
обрабатывать:  обрабатывать
предоставить:  предоставить
москва:  москва
прибор:  прибор
поддерживаться:  поддерживаться
большинство:  большинство
клип:  клип
уровень:  уровень
условие:  условие
насколько:  насколько
подключение:  подключение
калибровка:  калибровка
россия:  россия
воспользоваться:  воспользоваться
бензовоз:  бензовоз
шина:  шина
развивать:  развивать
затрата:  затрата
отчёт:  отчёт
перевозка:  перевозка
обманывать:  обманывать
повышение:  повышение
экономить:  экономить
команда:  команда
рынок:  рынок
трек:  трек
мы:  мы
удаться:  удаться
кейс:  кейс
глонасс:  глонасс
вход:  вход
дед:  дед
плод:  плод
блог:  блог
дыра:  дыра
процесс:  процесс
несоблюдение:  несоблюдение
краснодар:  краснодар
оснастить:  оснастить
требование:  требование
трое:  трое
сотрудничество:  сотрудничество
разрабатывать:  разрабатывать
срок:  срок
сотрудничать:  сотрудничать
техобслуживание:  техобслуживание
более:  более
квартира:  квартира
повыситься:  повыситься
саранск:  саранск
являться:  являться
назад:  назад
эффективно:  эффективно
поддержка:  поддержка
время:  время
оборудование:  оборудование
позвонить:  позвонить
служба:  служба
обслуживание:  обслуживание
замена:  замена
получать:  получать
км:  км
вопрос:  вопрос
спидометр:  спидометр
рассчитать:  рассчитать
повысить:  повысить
терминал:  терминал
комбайн:  комбайн
политика:  политика
специалист:  специалист
исключить:  исключить
талон:  талон
июль:  июль
напоминать:  напоминать
обновление:  обновление
интернет:  интернет
обслуживать:  обслуживать
брянск:  брянск
присвоить:  присвоить
объект:  объект
автотранспорт:  автотранспорт
исключение:  исключение
нарушение:  нарушение
эффект:  эффект
комментарий:  комментарий
большой:  большой
значительно:  значительно
именно:  именно
пенза:  пенза
граница:  граница
отмечать:  отмечать
построить:  построить
лицензия:  лицензия
автоматизация:  автоматизация
сопровождение:  сопровождение
единица:  единица
использование:  использование
подтверждаться:  подтверждаться
оформить:  оформить
работа:  работа
исчезать:  исчезать
ставрополь:  ставрополь
найти:  найти
кабинет:  кабинет
выгода:  выгода
сфера:  сфера
волгоград:  волгоград
лидер:  лидер
папанов:  папанов
готовый:  готовый
они:  они
объём:  объём
производительность:  производительность
размер:  размер
платформа:  платформа
интегрировать:  интегрировать
вещь:  вещь
отправить:  отправить
поле:  поле
рассчитывать:  рассчитывать
число:  число
список:  список
обеспечение:  обеспечение
снижать:  снижать
учёт:  учёт
оао:  оао
вместимость:  вместимость
происходить:  происходить
день:  день
вводиться:  вводиться
контролировать:  контролировать
издержка:  издержка
рф:  рф
заказать:  заказать
зао:  зао
способ:  способ
телефон:  телефон
имя:  имя
расхождение:  расхождение
рекомендация:  рекомендация
расстояние:  расстояние
порядок:  порядок
поволжье:  поволжье
вывести:  вывести
приёмка:  приёмка
метод:  метод
выбрать:  выбрать
помощь:  помощь
рождение:  рождение
ростов-на-дону:  ростов-на-дону
атол:  атол
быть:  быть
списывать:  списывать
себя:  себя
превратиться:  превратиться
пресс-центр:  пресс-центр
область:  область
приближаться:  приближаться
база:  база
липецк:  липецк
сбор:  сбор
конфиденциальность:  конфиденциальность
где:  где
нужно:  нужно
сумма:  сумма
решать:  решать
создать:  создать
пожинать:  пожинать
устройство:  устройство
штат:  штат
трактор:  трактор
сертификат:  сертификат
средство:  средство
позволять:  позволять
указать:  указать
я:  я
отметить:  отметить
