сочетание:  сочетание
клавиша:  клавиша
не:  не
выяснить:  выяснить
интересно:  интересно
видный:  видный
сегодня:  сегодня
подключиться:  подключиться
способ:  способ
активироваться:  активироваться
проверка:  проверка
рабочий:  рабочий
есть:  есть
нужно:  нужно
оно:  оно
копирование:  копирование
он:  он
представлять:  представлять
только:  только
они:  они
неприкосновенность:  неприкосновенность
ссылка:  ссылка
функция:  функция
пользоваться:  пользоваться
вы:  вы
служба:  служба
дело:  дело
задача:  задача
что:  что
угол:  угол
можно:  можно
несколько:  несколько
это:  это
пожаловать:  пожаловать
надо:  надо
исправить:  исправить
игра:  игра
право:  право
компьютер:  компьютер
система:  система
комплектующие:  комплектующие
программа:  программа
запустить:  запустить
помощь:  помощь
активатор:  активатор
нажатие:  нажатие
раз:  раз
лицензия:  лицензия
грузиться:  грузиться
убрать:  убрать
текст:  текст
модель:  модель
удаваться:  удаваться
режим:  режим
активировать:  активировать
надпись:  надпись
тематика:  тематика
блог:  блог
антивирус:  антивирус
обстоять:  обстоять
работать:  работать
гарантировать:  гарантировать
напоминание:  напоминание
кнопка:  кнопка
добро:  добро
диск:  диск
стоить:  стоить
связь:  связь
появляться:  появляться
отключить:  отключить
видеокарта:  видеокарта
много:  много
открываться:  открываться
обеспечение:  обеспечение
себя:  себя
активация:  активация
полезно:  полезно
самостоятельно:  самостоятельно
статья:  статья
зависание:  зависание
защита:  защита
всё:  всё
наличие:  наличие
открыть:  открыть
вариант:  вариант
сталкиваться:  сталкиваться
узнать:  узнать
память:  память
обновление:  обновление
характеристика:  характеристика
отказываться:  отказываться
половина:  половина
диспетчер:  диспетчер
устранить:  устранить
переставать:  переставать
оборудование:  оборудование
стол:  стол
список:  список
процессор:  процессор
поиск:  поиск
