новость:  новость
компания:  компания
клиент:  клиент
взаимодействие:  взаимодействие
управление:  управление
тэк:  тэк
пользователь:  пользователь
доступный:  доступный
перечень:  перечень
уплата:  уплата
сертификат:  сертификат
доход:  доход
справка:  справка
внедрение:  внедрение
редакция:  редакция
сизый:  сизый
характер:  характер
фнс:  фнс
бизнес-процесс:  бизнес-процесс
подключиться:  подключиться
февраль:  февраль
использовать:  использовать
обзор:  обзор
семинар:  семинар
маркировка:  маркировка
купить:  купить
софт:  софт
забыть:  забыть
выдача:  выдача
укладываться:  укладываться
учреждение:  учреждение
отдел:  отдел
быть:  быть
лицо:  лицо
компетенция:  компетенция
представить:  представить
мы:  мы
регион:  регион
решение:  решение
всё:  всё
среднее:  среднее
релиз:  релиз
правило:  правило
адрес:  адрес
являться:  являться
ооо:  ооо
звонок:  звонок
выпуск:  выпуск
сервис:  сервис
код:  код
потребность:  потребность
гк:  гк
вы:  вы
труд:  труд
январь:  январь
вопрос:  вопрос
нетрудоспособность:  нетрудоспособность
подавать:  подавать
корректность:  корректность
поддержка:  поддержка
связь:  связь
декларация:  декларация
обладать:  обладать
работа:  работа
заметка:  заметка
руководитель:  руководитель
обучение:  обучение
курс:  курс
применение:  применение
опыт:  опыт
отряд:  отряд
специализировать:  специализировать
набор:  набор
состав:  состав
платформа:  платформа
оао:  оао
организация:  организация
ноябрь:  ноябрь
позволять:  позволять
стать:  стать
предприятие:  предприятие
удобство:  удобство
контакт:  контакт
разработка:  разработка
центр:  центр
внедрить:  внедрить
издержка:  издержка
перейти:  перейти
фотогалерея:  фотогалерея
задать:  задать
выбор:  выбор
разработать:  разработать
мрот:  мрот
накопить:  накопить
программа:  программа
перерегистрировать:  перерегистрировать
функциональность:  функциональность
мастер:  мастер
интегрироваться:  интегрироваться
инструкция:  инструкция
вакансия:  вакансия
цена:  цена
заказать:  заказать
сокращать:  сокращать
декабрь:  декабрь
телефон:  телефон
я:  я
методика:  методика
реквизит:  реквизит
регистрация:  регистрация
прайс-лист:  прайс-лист
версия:  версия
аккредитовать:  аккредитовать
акция:  акция
соответствие:  соответствие
тестирование:  тестирование
учёт:  учёт
задача:  задача
нацелить:  нацелить
оценка:  оценка
бизнес:  бизнес
слово:  слово
статья:  статья
помощь:  помощь
ключ:  ключ
фирма:  фирма
автоматизация:  автоматизация
развиваться:  развиваться
выбрать:  выбрать
вариант:  вариант
зарегистрировать:  зарегистрировать
описать:  описать
промышленность:  промышленность
поставляться:  поставляться
данные:  данные
сайт:  сайт
предназначить:  предназначить
качество:  качество
интеграция:  интеграция
бесплатно:  бесплатно
понимание:  понимание
войти:  войти
апрель:  апрель
сопровождение:  сопровождение
не:  не
результат:  результат
деятельность:  деятельность
это:  это
политика:  политика
рекомендовать:  рекомендовать
подписаться:  подписаться
база:  база
проект:  проект
направление:  направление
листок:  листок
технология:  технология
оказание:  оказание
конфиденциальность:  конфиденциальность
оферта:  оферта
комплект:  комплект
июль:  июль
анкета:  анкета
облако:  облако
бухгалтерия:  бухгалтерия
носить:  носить
получить:  получить
далее:  далее
нужно:  нужно
порядок:  порядок
уведомление:  уведомление
учитываться:  учитываться
приборостроение:  приборостроение
запомнить:  запомнить
счёт:  счёт
ес:  ес
партнёр:  партнёр
налог:  налог
условие:  условие
розница:  розница
материал:  материал
иса:  иса
отзыв:  отзыв
запустить:  запустить
известно:  известно
предприниматель:  предприниматель
ввести:  ввести
год:  год
система:  система
обязать:  обязать
обработка:  обработка
комментарий:  комментарий
заявка:  заявка
минфин:  минфин
сдавать:  сдавать
величина:  величина
прошедшее:  прошедшее
мероприятие:  мероприятие
удалённый:  удалённый
зарегистрироваться:  зарегистрироваться
просто:  просто
апгрейд:  апгрейд
график:  график
вычет:  вычет
отчётность:  отчётность
линейка:  линейка
лицензия:  лицензия
регламент:  регламент
продукт:  продукт
место:  место
ссылка:  ссылка
услуга:  услуга
россия:  россия
собственник:  собственник
оформление:  оформление
специализироваться:  специализироваться
сотрудник:  сотрудник
