ящик:  ящик
библиотека:  библиотека
каталог:  каталог
она:  она
потребоваться:  потребоваться
помогать:  помогать
разбитие:  разбитие
сборка:  сборка
софт:  софт
набор:  набор
использование:  использование
аудио:  аудио
громкость:  громкость
запуск:  запуск
попытка:  попытка
эмулятор:  эмулятор
конвертор:  конвертор
обеспечивать:  обеспечивать
образ:  образ
избавить:  избавить
воспроизвести:  воспроизвести
версия:  версия
функция:  функция
есть:  есть
оптимизатор:  оптимизатор
точка:  точка
связь:  связь
что:  что
продукт:  продукт
получить:  получить
создание:  создание
количество:  количество
оптимизация:  оптимизация
отправление:  отправление
вызывать:  вызывать
надёжно:  надёжно
доступно:  доступно
ноутбук:  ноутбук
мы:  мы
сканирование:  сканирование
разбиение:  разбиение
ввод:  ввод
разработчик:  разработчик
пароль:  пароль
выгрузка:  выгрузка
обучать:  обучать
мусор:  мусор
защитить:  защитить
ориентировать:  ориентировать
освободить:  освободить
состав:  состав
редактор:  редактор
чистка:  чистка
клик:  клик
чтение:  чтение
винчестер:  винчестер
удаление:  удаление
основа:  основа
лечение:  лечение
интерфейс:  интерфейс
работа:  работа
функционирование:  функционирование
запись:  запись
лежать:  лежать
стать:  стать
проигрывание:  проигрывание
архив:  архив
фотография:  фотография
программа:  программа
выполнить:  выполнить
собрать:  собрать
данные:  данные
представитель:  представитель
всегда:  всегда
наделить:  наделить
страница:  страница
монтаж:  монтаж
возможность:  возможность
предлагать:  предлагать
сжатие:  сжатие
лишь:  лишь
наличие:  наличие
быстро:  быстро
информация:  информация
раздать:  раздать
использоваться:  использоваться
браузер:  браузер
надельный:  надельный
проверка:  проверка
нужно:  нужно
копирование:  копирование
организовать:  организовать
управлять:  управлять
иметь:  иметь
быть:  быть
просмотр:  просмотр
поиск:  поиск
производительность:  производительность
контроль:  контроль
поддерживать:  поддерживать
это:  это
кадр:  кадр
доступ:  доступ
закачка:  закачка
распаковка:  распаковка
конфиденциальность:  конфиденциальность
документ:  документ
ремонт:  ремонт
формат:  формат
кодек:  кодек
очистка:  очистка
встроить:  встроить
защита:  защита
обновление:  обновление
файл:  файл
пользователь:  пользователь
устранение:  устранение
просмотреть:  просмотреть
устранить:  устранить
рядом:  рядом
аудиозапись:  аудиозапись
оживить:  оживить
режим:  режим
мочь:  мочь
представить:  представить
телефония:  телефония
музыка:  музыка
бесплатно:  бесплатно
цель:  цель
доступный:  доступный
менять:  менять
возможный:  возможный
запаковать:  запаковать
условие:  условие
предназначить:  предназначить
почта:  почта
тестирование:  тестирование
он:  он
редактирование:  редактирование
система:  система
описание:  описание
безопасность:  безопасность
реализовать:  реализовать
исправление:  исправление
восстановление:  восстановление
клиент:  клиент
веб-камера:  веб-камера
вокал:  вокал
справляться:  справляться
делать:  делать
обработка:  обработка
портал:  портал
дефрагментация:  дефрагментация
ускорение:  ускорение
независимо:  независимо
инструмент:  инструмент
выполнять:  выполнять
содержать:  содержать
редактировать:  редактировать
задача:  задача
записывать:  записывать
превратить:  превратить
взаимодействие:  взаимодействие
скачивание:  скачивание
запустить:  запустить
скачать:  скачать
архивация:  архивация
диагностика:  диагностика
удалить:  удалить
увеличение:  увеличение
повышение:  повышение
веб-сёрфинг:  веб-сёрфинг
себя:  себя
звук:  звук
качество:  качество
сортировка:  сортировка
флешка:  флешка
они:  они
воспроизведение:  воспроизведение
компьютер:  компьютер
плеер:  плеер
обрабатывать:  обрабатывать
регулярно:  регулярно
синхронизация:  синхронизация
можно:  можно
слой:  слой
позволить:  позволить
разгон:  разгон
язык:  язык
оптимизировать:  оптимизировать
совмещать:  совмещать
вернуть:  вернуть
веб:  веб
выбрать:  выбрать
предупреждать:  предупреждать
позволять:  позволять
убрать:  убрать
гарантировать:  гарантировать
закладка:  закладка
интегрироваться:  интегрироваться
входить:  входить
правка:  правка
форма:  форма
роутер:  роутер
прервать:  прервать
чистильщик:  чистильщик
оболочка:  оболочка
загрузка:  загрузка
влиять:  влиять
много:  много
обеспечение:  обеспечение
решение:  решение
действовать:  действовать
изучение:  изучение
обнаружить:  обнаружить
захват:  захват
изменить:  изменить
установка:  установка
предоставлять:  предоставлять
диск:  диск
средство:  средство
эффективно:  эффективно
ошибка:  ошибка
загрузить:  загрузить
создавать:  создавать
выход:  выход
не:  не
контент:  контент
представлять:  представлять
прийти:  прийти
сломать:  сломать
осуществить:  осуществить
прожига:  прожига
ножницы:  ножницы
детище:  детище
бд:  бд
прокрутка:  прокрутка
помощь:  помощь
заточить:  заточить
эффект:  эффект
видео:  видео
создать:  создать
накладывать:  накладывать
заменить:  заменить
недоставать:  недоставать
поддержка:  поддержка
появляться:  появляться
получать:  получать
пк:  пк
антивирус:  антивирус
управление:  управление
скопировать:  скопировать
наиболее:  наиболее
угроза:  угроза
обрезать:  обрезать
продвинуть:  продвинуть
регистрация:  регистрация
скорость:  скорость
всё:  всё
распознавание:  распознавание
компонент:  компонент
являться:  являться
прослушивание:  прослушивание
часть:  часть
практически:  практически
раскрыть:  раскрыть
пара:  пара
добавить:  добавить
использовать:  использовать
