анимация:  анимация
составлять:  составлять
подключение:  подключение
вещание:  вещание
доступный:  доступный
позволять:  позволять
шифроваться:  шифроваться
сеть:  сеть
предназначение:  предназначение
аудиоредактор:  аудиоредактор
использование:  использование
конвейер:  конвейер
результат:  результат
не:  не
программа:  программа
основать:  основать
рекомендовать:  рекомендовать
подключить:  подключить
интерьер:  интерьер
переключение:  переключение
аудио:  аудио
возможность:  возможность
информация:  информация
карта:  карта
микшер:  микшер
пакет:  пакет
браузер:  браузер
многое:  многое
поток:  поток
формат:  формат
безопасность:  безопасность
профиль:  профиль
воссоздавать:  воссоздавать
отчёт:  отчёт
генеалогия:  генеалогия
абсолютно:  абсолютно
создать:  создать
версия:  версия
копирование:  копирование
сделать:  сделать
добавлять:  добавлять
запуск:  запуск
комплекс:  комплекс
отправлять:  отправлять
упор:  упор
проработать:  проработать
файл:  файл
они:  они
компьютер:  компьютер
воспроизведение:  воспроизведение
ремонт:  ремонт
ссылка:  ссылка
астрология:  астрология
функционал:  функционал
более:  более
поиск:  поиск
обуславливать:  обуславливать
год:  год
уметь:  уметь
просмотр:  просмотр
иметь:  иметь
использоваться:  использоваться
управлять:  управлять
вывод:  вывод
настройка:  настройка
использовать:  использовать
упомянуть:  упомянуть
агрегатор:  агрегатор
сценарий:  сценарий
архиватор:  архиватор
контроль:  контроль
движок:  движок
можно:  можно
сообщение:  сообщение
участник:  участник
задать:  задать
продукт:  продукт
тест:  тест
прекрасно:  прекрасно
игра:  игра
сервер:  сервер
страница:  страница
чат:  чат
форум:  форум
главное:  главное
дать:  дать
входить:  входить
содержимое:  содержимое
интерфейс:  интерфейс
писать:  писать
оптимизация:  оптимизация
просматривать:  просматривать
поддерживать:  поддерживать
ввод:  ввод
состав:  состав
встроить:  встроить
система:  система
метод:  метод
действие:  действие
раздел:  раздел
работа:  работа
узел:  узел
протокол:  протокол
выводиться:  выводиться
умолчание:  умолчание
модель:  модель
форматирование:  форматирование
звук:  звук
работать:  работать
наличие:  наличие
исключение:  исключение
веб-сайт:  веб-сайт
кодек:  кодек
видео:  видео
веб:  веб
восстановление:  восстановление
функция:  функция
соединение:  соединение
категория:  категория
код:  код
упрощать:  упрощать
просмотреть:  просмотреть
полностью:  полностью
передача:  передача
изменять:  изменять
запись:  запись
сайт:  сайт
особенность:  особенность
утилита:  утилита
находиться:  находиться
данные:  данные
статья:  статья
уязвимость:  уязвимость
идентификация:  идентификация
поддержка:  поддержка
это:  это
обладать:  обладать
антивирус:  антивирус
обзор:  обзор
пользователь:  пользователь
трансляция:  трансляция
музыка:  музыка
план:  план
большинство:  большинство
редактор:  редактор
торрент:  торрент
умение:  умение
стоить:  стоить
вывести:  вывести
среда:  среда
автоматически:  автоматически
помощь:  помощь
структура:  структура
дизайн:  дизайн
создание:  создание
выбирать:  выбирать
пароль:  пароль
часть:  часть
необходимо:  необходимо
сохранять:  сохранять
загрузка:  загрузка
утратить:  утратить
жизнь:  жизнь
устройство:  устройство
совершение:  совершение
обмен:  обмен
сохранить:  сохранить
присутствовать:  присутствовать
синхронизация:  синхронизация
состояние:  состояние
восстановить:  восстановить
авторизация:  авторизация
модуль:  модуль
скорость:  скорость
микширование:  микширование
всё:  всё
источник:  источник
характеристика:  характеристика
описание:  описание
поступление:  поступление
разработчик:  разработчик
веб-браузер:  веб-браузер
компания:  компания
активно:  активно
редактирование:  редактирование
уровень:  уровень
накопитель:  накопитель
каталог:  каталог
клиент:  клиент
сектор:  сектор
продвинуть:  продвинуть
читать:  читать
обработка:  обработка
реализация:  реализация
выполнение:  выполнение
скатить:  скатить
моделирование:  моделирование
диск:  диск
включить:  включить
защита:  защита
память:  память
являться:  являться
переустановка:  переустановка
разнообразие:  разнообразие
пересоздавать:  пересоздавать
добавление:  добавление
легко:  легко
практически:  практически
изменение:  изменение
детально:  детально
соблюдение:  соблюдение
текстура:  текстура
перейти:  перейти
вестись:  вестись
