скатка:  скатка
деталь:  деталь
стоимость:  стоимость
фактор:  фактор
украина:  украина
приносить:  приносить
давать:  давать
бизнес:  бизнес
оптом:  оптом
бывать:  бывать
заявка:  заявка
начать:  начать
рынок:  рынок
позиция:  позиция
слово:  слово
конкурент:  конкурент
составить:  составить
анализировать:  анализировать
делать:  делать
это:  это
лидер:  лидер
подходить:  подходить
рекомендация:  рекомендация
развитие:  развитие
день:  день
робот:  робот
владимир:  владимир
общаться:  общаться
хотеть:  хотеть
рост:  рост
пилинг:  пилинг
работать:  работать
месяц:  месяц
сайт:  сайт
что:  что
доверие:  доверие
ключ:  ключ
положительно:  положительно
агентство:  агентство
договор:  договор
заказ:  заказ
влиять:  влиять
проводок:  проводок
столько:  столько
увеличиться:  увеличиться
цель:  цель
трафик:  трафик
прирост:  прирост
реклама:  реклама
битва:  битва
задача:  задача
релевантный:  релевантный
конверсия:  конверсия
часто:  часто
избежать:  избежать
вы:  вы
ошибка:  ошибка
опыт:  опыт
получить:  получить
стратегия:  стратегия
корея:  корея
простыня:  простыня
выбрать:  выбрать
проект:  проект
посещаемость:  посещаемость
задержаться:  задержаться
клиент:  клиент
предоставить:  предоставить
снг:  снг
оптимизация:  оптимизация
подход:  подход
приехать:  приехать
оставлять:  оставлять
отслеживать:  отслеживать
хороший:  хороший
он:  он
час:  час
знак:  знак
менять:  менять
телеканал:  телеканал
мониторинг:  мониторинг
поток:  поток
наиболее:  наиболее
исправить:  исправить
создать:  создать
направление:  направление
статистика:  статистика
секунда:  секунда
интервью:  интервью
тема:  тема
вот:  вот
звонок:  звонок
важно:  важно
выше:  выше
мало:  мало
успешно:  успешно
массив:  массив
пивоварня:  пивоварня
продажа:  продажа
иметь:  иметь
расти:  расти
косметика:  косметика
контакт:  контакт
провести:  провести
быть:  быть
сми:  сми
посетитель:  посетитель
должный:  должный
почему:  почему
работа:  работа
много:  много
совершить:  совершить
проводиться:  проводиться
я:  я
риск:  риск
получать:  получать
причина:  причина
вести:  вести
квалификация:  квалификация
смочь:  смочь
узнать:  узнать
прибыль:  прибыль
относиться:  относиться
ссылка:  ссылка
взлетать:  взлетать
год:  год
подарок:  подарок
готовить:  готовить
инструмент:  инструмент
предоставление:  предоставление
просто:  просто
пользователь:  пользователь
они:  они
регулярно:  регулярно
картина:  картина
проводить:  проводить
максимум:  максимум
связь:  связь
привести:  привести
сложность:  сложность
видеоролик:  видеоролик
состояться:  состояться
помогать:  помогать
текст:  текст
купить:  купить
киев:  киев
мы:  мы
кейс:  кейс
опасность:  опасность
подбирать:  подбирать
задание:  задание
подробный:  подробный
савчук:  савчук
контент:  контент
пакет:  пакет
процесс:  процесс
интернет:  интернет
информация:  информация
портянка:  портянка
более:  более
разместить:  разместить
перенасытить:  перенасытить
скачать:  скачать
поэтому:  поэтому
время:  время
оборудование:  оборудование
тогда:  тогда
решение:  решение
показатель:  показатель
увидеть:  увидеть
канал:  канал
способствовать:  способствовать
эксперт:  эксперт
результат:  результат
остаться:  остаться
магазин:  магазин
ранжирование:  ранжирование
право:  право
сделать:  сделать
звонить:  звонить
ремонт:  ремонт
раскрутка:  раскрутка
сколько:  сколько
исправление:  исправление
подобрать:  подобрать
сервис:  сервис
увеличение:  увеличение
проблема:  проблема
минута:  минута
нести:  нести
обсуждать:  обсуждать
компания:  компания
калькулятор:  калькулятор
минь:  минь
очень:  очень
действительно:  действительно
создание:  создание
отобрать:  отобрать
сфера:  сфера
всё:  всё
принести:  принести
проверить:  проверить
улучшение:  улучшение
топ:  топ
запрос:  запрос
подарить:  подарить
количество:  количество
сегодня:  сегодня
сразу:  сразу
качественно:  качественно
начинать:  начинать
улучшить:  улучшить
использовать:  использовать
удобство:  удобство
заказать:  заказать
встреча:  встреча
привлекать:  привлекать
специалист:  специалист
подписывать:  подписывать
миссия:  миссия
дорога:  дорога
помощь:  помощь
продвигать:  продвигать
выстраивать:  выстраивать
экскурсия:  экскурсия
предоплата:  предоплата
не:  не
неделя:  неделя
гарантировать:  гарантировать
рекомендовать:  рекомендовать
возможность:  возможность
оставить:  оставить
подбор:  подбор
раз:  раз
конец:  конец
разработать:  разработать
ожидать:  ожидать
фраза:  фраза
аудит:  аудит
анализ:  анализ
король:  король
радость:  радость
поведение:  поведение
позволять:  позволять
офис:  офис
только:  только
план:  план
услуга:  услуга
заботиться:  заботиться
