обеспечение:  обеспечение
звонок:  звонок
процесс:  процесс
отдел:  отдел
телефон:  телефон
компания:  компания
режим:  режим
качество:  качество
пользоваться:  пользоваться
кук:  кук
ресурс:  ресурс
автоматизация:  автоматизация
политика:  политика
являться:  являться
комплект:  комплект
клара:  клара
продукт:  продукт
внедрение:  внедрение
кабинет:  кабинет
водоочистка:  водоочистка
продолжать:  продолжать
подробность:  подробность
стандарт:  стандарт
год:  год
набор:  набор
программирование:  программирование
способный:  способный
упрощение:  упрощение
более:  более
возможность:  возможность
дело:  дело
сложность:  сложность
сервис:  сервис
конфигурирование:  конфигурирование
траектория:  траектория
бизнес:  бизнес
сбор:  сбор
клиент:  клиент
технология:  технология
функция:  функция
основать:  основать
партнёр:  партнёр
область:  область
конфиденциальность:  конфиденциальность
система:  система
адаптация:  адаптация
интеграция:  интеграция
сеть:  сеть
помогать:  помогать
номер:  номер
мы:  мы
вы:  вы
новость:  новость
повышать:  повышать
стадия:  стадия
сфера:  сфера
разработчик:  разработчик
обращаться:  обращаться
ноябрь:  ноябрь
асу:  асу
заказчик:  заказчик
эффективность:  эффективность
разработка:  разработка
сертифицировать:  сертифицировать
продажа:  продажа
модернизация:  модернизация
передача:  передача
основание:  основание
вакансия:  вакансия
партнерс:  партнерс
экономить:  экономить
поддержка:  поддержка
справиться:  справиться
статья:  статья
соглашаться:  соглашаться
видео:  видео
предприятие:  предприятие
событие:  событие
управление:  управление
проект:  проект
использовать:  использовать
пройти:  пройти
аналитика:  аналитика
статистика:  статистика
администрация:  администрация
требование:  требование
связь:  связь
решение:  решение
использование:  использование
ооо:  ооо
адрес:  адрес
посещение:  посещение
производство:  производство
соответствие:  соответствие
время:  время
выбор:  выбор
основа:  основа
пресса:  пресса
генерация:  генерация
контакт:  контакт
совместимость:  совместимость
момент:  момент
беларусь:  беларусь
большинство:  большинство
всё:  всё
визуализация:  визуализация
платформа:  платформа
защита:  защита
комментарий:  комментарий
профессионал:  профессионал
сбой:  сбой
имя:  имя
ос:  ос
устройство:  устройство
сайт:  сайт
мир:  мир
заказать:  заказать
сертификация:  сертификация
задача:  задача
сопровождение:  сопровождение
данные:  данные
я:  я
версия:  версия
