внедрение:  внедрение
проект:  проект
автоматизация:  автоматизация
мы:  мы
узнать:  узнать
привязка:  привязка
быть:  быть
снижать:  снижать
отрасль:  отрасль
отражаться:  отражаться
сократиться:  сократиться
позволить:  позволить
заказчик:  заказчик
система:  система
рейс:  рейс
возможность:  возможность
утилизация:  утилизация
продукт:  продукт
поведение:  поведение
курьер:  курьер
программа:  программа
отслеживать:  отслеживать
заполнить:  заполнить
достигнуть:  достигнуть
точка:  точка
новость:  новость
год:  год
координата:  координата
привезти:  привезти
дистанция:  дистанция
презентация:  презентация
подход:  подход
повлечь:  повлечь
фиксировать:  фиксировать
указать:  указать
заявка:  заявка
партнёр:  партнёр
выбирать:  выбирать
офис:  офис
оплата:  оплата
помощь:  помощь
совместно:  совместно
уточнить:  уточнить
водитель:  водитель
применение:  применение
централизовать:  централизовать
раз:  раз
кардинально:  кардинально
масштабирование:  масштабирование
всё:  всё
объём:  объём
обслуживание:  обслуживание
невыполнение:  невыполнение
отдел:  отдел
храниться:  храниться
мониторинг:  мониторинг
интеграция:  интеграция
поступление:  поступление
работа:  работа
считать:  считать
приём:  приём
сайт:  сайт
название:  название
страница:  страница
не:  не
построение:  построение
доставка:  доставка
логист:  логист
сотня:  сотня
долгий:  долгий
опоздание:  опоздание
сотрудник:  сотрудник
сборка:  сборка
выполнять:  выполнять
запрос:  запрос
необходимый:  необходимый
что:  что
поддерживать:  поддерживать
итог:  итог
продажа:  продажа
расход:  расход
служба:  служба
ограничение:  ограничение
отметить:  отметить
управление:  управление
неравномерность:  неравномерность
день:  день
улучшение:  улучшение
режим:  режим
себестоимость:  себестоимость
принимать:  принимать
себя:  себя
решение:  решение
время:  время
сбыт:  сбыт
оценить:  оценить
предназначить:  предназначить
есть:  есть
обмен:  обмен
данные:  данные
запланировать:  запланировать
подстраиваться:  подстраиваться
развиваться:  развиваться
увеличить:  увеличить
рамка:  рамка
видный:  видный
количество:  количество
более:  более
показать:  показать
она:  она
найти:  найти
статус:  статус
пара:  пара
экспортировать:  экспортировать
завысить:  завысить
компания:  компания
решать:  решать
лояльность:  лояльность
помогать:  помогать
стабильно:  стабильно
подробный:  подробный
учёт:  учёт
распределение:  распределение
справиться:  справиться
обеспечивать:  обеспечивать
хлеб:  хлеб
составление:  составление
история:  история
идти:  идти
запросить:  запросить
быстрый:  быстрый
температура:  температура
прозрачный:  прозрачный
удаваться:  удаваться
работать:  работать
область:  область
улучшиться:  улучшиться
легко:  легко
пн:  пн
клиент:  клиент
условие:  условие
филиал:  филиал
маршрут:  маршрут
пробег:  пробег
степень:  степень
настраивать:  настраивать
качество:  качество
возрасти:  возрасти
сотрудничество:  сотрудничество
контроль:  контроль
повысить:  повысить
сложно:  сложно
оптимизация:  оптимизация
заказать:  заказать
мочь:  мочь
следить:  следить
требование:  требование
рынок:  рынок
модульность:  модульность
демонстрация:  демонстрация
город:  город
обработка:  обработка
зона:  зона
согласие:  согласие
бизнес-процесс:  бизнес-процесс
компетенция:  компетенция
обратиться:  обратиться
маленький:  маленький
вызов:  вызов
интернет-магазин:  интернет-магазин
дать:  дать
автопарк:  автопарк
своевременно:  своевременно
изменение:  изменение
рост:  рост
лидер:  лидер
открыть:  открыть
снизить:  снизить
поддержка:  поддержка
должный:  должный
ооо:  ооо
сколько:  сколько
заказ:  заказ
дата:  дата
санкция:  санкция
комплект:  комплект
экономия:  экономия
осуществляться:  осуществляться
улица:  улица
всегда:  всегда
логистика:  логистика
соответствие:  соответствие
использование:  использование
верить:  верить
крыться:  крыться
интерфейс:  интерфейс
карта:  карта
позволять:  позволять
проблема:  проблема
месяц:  месяц
отнимать:  отнимать
возрастать:  возрастать
отвечать:  отвечать
дополнять:  дополнять
они:  они
груз:  груз
причина:  причина
машина:  машина
нужно:  нужно
потеря:  потеря
звонок:  звонок
бесплатно:  бесплатно
сразу:  сразу
реальность:  реальность
нет:  нет
представитель:  представитель
риск:  риск
уровень:  уровень
агент:  агент
транспорт:  транспорт
единица:  единица
опыт:  опыт
план:  план
бизнес:  бизнес
выяснение:  выяснение
визуально:  визуально
практически:  практически
дорога:  дорога
персонал:  персонал
привести:  привести
выгрузка:  выгрузка
сервис:  сервис
хороший:  хороший
специалист:  специалист
визит:  визит
тратить:  тратить
загрузка:  загрузка
сокращение:  сокращение
переплачивать:  переплачивать
перевозка:  перевозка
сделать:  сделать
нехватка:  нехватка
вместе:  вместе
разработать:  разработать
стоимость:  стоимость
счёт:  счёт
посмотреть:  посмотреть
планирование:  планирование
независимо:  независимо
склад:  склад
гибкость:  гибкость
большой:  большой
затрата:  затрата
задача:  задача
расти:  расти
отдельность:  отдельность
перспектива:  перспектива
выполнение:  выполнение
управлять:  управлять
комплекс:  комплекс
определить:  определить
доверять:  доверять
срок:  срок
коэффициент:  коэффициент
безопасность:  безопасность
оптимизировать:  оптимизировать
стать:  стать
полный:  полный
появляться:  появляться
вопрос:  вопрос
внимание:  внимание
адрес:  адрес
подробно:  подробно
окупаться:  окупаться
маршрутизация:  маршрутизация
среднее:  среднее
выражать:  выражать
этап:  этап
настраиваться:  настраиваться
товар:  товар
занимать:  занимать
уверить:  уверить
контакт:  контакт
достигать:  достигать
почему:  почему
иметь:  иметь
ущерб:  ущерб
каталог:  каталог
друг:  друг
мероприятие:  мероприятие
обращать:  обращать
информация:  информация
эффективный:  эффективный
принять:  принять
хранение:  хранение
выше:  выше
соблюдение:  соблюдение
приходиться:  приходиться
пресс-релиз:  пресс-релиз
схема:  схема
настройка:  настройка
подтверждать:  подтверждать
приходить:  приходить
утрата:  утрата
дом:  дом
организация:  организация
регион:  регион
введение:  введение
установление:  установление
несколько:  несколько
функционирование:  функционирование
сегодня:  сегодня
передача:  передача
внедрять:  внедрять
разработчик:  разработчик
приписка:  приписка
это:  это
результат:  результат
можно:  можно
наличие:  наличие
форма:  форма
использоваться:  использоваться
предлагать:  предлагать
уверенно:  уверенно
кузов:  кузов
ресурс:  ресурс
ряд:  ряд
сократить:  сократить
дистрибуция:  дистрибуция
увеличение:  увеличение
диспетчер:  диспетчер
преимущество:  преимущество
подробность:  подробность
подключить:  подключить
гк:  гк
успех:  успех
отчёт:  отчёт
право:  право
удовлетворённость:  удовлетворённость
рассчитать:  рассчитать
принцип:  принцип
отклоняться:  отклоняться
уделить:  уделить
простой:  простой
многие:  многие
