проект:  проект
безопасность:  безопасность
это:  это
подробный:  подробный
понравиться:  понравиться
вы:  вы
хакерство:  хакерство
результат:  результат
продукт:  продукт
поддержка:  поддержка
разработчик:  разработчик
похожий:  похожий
документация:  документация
программа:  программа
руководство:  руководство
веб:  веб
соотношение:  соотношение
помощь:  помощь
обеспечение:  обеспечение
экран:  экран
пользователь:  пользователь
софт:  софт
платформа:  платформа
рассказать:  рассказать
много:  много
оплата:  оплата
посоветовать:  посоветовать
идея:  идея
увеличить:  увеличить
быть:  быть
раскрутка:  раскрутка
интернет:  интернет
скачать:  скачать
применение:  применение
топ:  топ
друг:  друг
память:  память
предоставить:  предоставить
производить:  производить
количество:  количество
развитие:  развитие
сфера:  сфера
разработка:  разработка
поддержать:  поддержать
файрволл:  файрволл
программирование:  программирование
сайт:  сайт
способ:  способ
версия:  версия
сеть:  сеть
оптимизация:  оптимизация
система:  система
наиболее:  наиболее
очистка:  очистка
компьютер:  компьютер
позволить:  позволить
ресурс:  ресурс
направление:  направление
деньга:  деньга
популярность:  популярность
отблагодарить:  отблагодарить
сообщество:  сообщество
сотня:  сотня
секрет:  секрет
управлять:  управлять
обезопасить:  обезопасить
защита:  защита
игра:  игра
посетитель:  посетитель
хакер:  хакер
смартфон:  смартфон
взлом:  взлом
категория:  категория
найти:  найти
стать:  стать
раздел:  раздел
написать:  написать
