обеспечение:  обеспечение
сканер:  сканер
подводить:  подводить
работоспособность:  работоспособность
утеря:  утеря
сервис:  сервис
извлечение:  извлечение
открытие:  открытие
создать:  создать
паспорт:  паспорт
использование:  использование
наличие:  наличие
не:  не
использовать:  использовать
компания:  компания
распознавание:  распознавание
режим:  режим
сайт:  сайт
клиент:  клиент
качество:  качество
анкета:  анкета
печать:  печать
большой:  большой
информация:  информация
отображать:  отображать
возможность:  возможность
видеопоток:  видеопоток
скан:  скан
предложить:  предложить
процесс:  процесс
классификация:  классификация
реализовать:  реализовать
ввод:  ввод
отчёт:  отчёт
платформа:  платформа
услуга:  услуга
она:  она
позволять:  позволять
нужно:  нужно
свидетельство:  свидетельство
требоваться:  требоваться
продукт:  продукт
обязательно:  обязательно
продолжать:  продолжать
ия:  ия
право:  право
оставить:  оставить
год:  год
извлекать:  извлекать
более:  более
фотография:  фотография
страна:  страна
использоваться:  использоваться
томография:  томография
продать:  продать
задача:  задача
причина:  причина
сми:  сми
это:  это
получить:  получить
текст:  текст
страница:  страница
представить:  представить
дать:  дать
новость:  новость
технология:  технология
рф:  рф
персонал:  персонал
произойти:  произойти
лицо:  лицо
привести:  привести
решить:  решить
конфиденциальность:  конфиденциальность
документ:  документ
штрихкод:  штрихкод
зрение:  зрение
работа:  работа
мы:  мы
вы:  вы
расширить:  расширить
карьера:  карьера
разработчик:  разработчик
веб:  веб
версия:  версия
оказывать:  оказывать
итог:  итог
улучшение:  улучшение
получение:  получение
система:  система
посетитель:  посетитель
применение:  применение
согласие:  согласие
модуль:  модуль
зона:  зона
мочь:  мочь
проведение:  проведение
файл:  файл
справка:  справка
замена:  замена
оформление:  оформление
опыт:  опыт
миллион:  миллион
камера:  камера
осуществлять:  осуществлять
блог:  блог
разработать:  разработать
сотрудничать:  сотрудничать
необходимость:  необходимость
кликнуть:  кликнуть
сделать:  сделать
база:  база
смартфон:  смартфон
форма:  форма
нажимать:  нажимать
соглашаться:  соглашаться
решение:  решение
автоматически:  автоматически
подробный:  подробный
проверить:  проверить
заполнить:  заполнить
актуализировать:  актуализировать
деятельность:  деятельность
тип:  тип
юрисдикция:  юрисдикция
транспорт:  транспорт
снг:  снг
вид:  вид
обновить:  обновить
предназначить:  предназначить
удостоверение:  удостоверение
объект:  объект
карта:  карта
сбор:  сбор
опросник:  опросник
наука:  наука
обработка:  обработка
офис:  офис
удостоверять:  удостоверять
контакт:  контакт
всё:  всё
открыть:  открыть
альфа-банк:  альфа-банк
условие:  условие
передача:  передача
приходить:  приходить
виза:  виза
личность:  личность
сканирование:  сканирование
позволить:  позволить
прямо:  прямо
наём:  наём
кнопка:  кнопка
заказать:  заказать
скачать:  скачать
заказ:  заказ
проверка:  проверка
приём:  приём
данные:  данные
внедрить:  внедрить
согласиться:  согласиться
