анализ:  анализ
уровень:  уровень
обеспечение:  обеспечение
повышение:  повышение
вопрос:  вопрос
каталог:  каталог
ожидать:  ожидать
позволять:  позволять
профессионализм:  профессионализм
читатель:  читатель
клиент:  клиент
она:  она
совместно:  совместно
тз:  тз
переносить:  переносить
процесс:  процесс
компания:  компания
появиться:  появиться
посещаемость:  посещаемость
характеристика:  характеристика
использовать:  использовать
изготовление:  изготовление
добиться:  добиться
информировать:  информировать
показатель:  показатель
позаботиться:  позаботиться
осуществить:  осуществить
ряд:  ряд
сайт:  сайт
поделиться:  поделиться
режим:  режим
обслуживание:  обслуживание
снабжаться:  снабжаться
ассортимент:  ассортимент
разработать:  разработать
страница:  страница
правильно:  правильно
свидетельствовать:  свидетельствовать
направление:  направление
ниша:  ниша
прописываться:  прописываться
браться:  браться
пример:  пример
запуск:  запуск
товарооборот:  товарооборот
интернет-магазин:  интернет-магазин
подбор:  подбор
запрос:  запрос
визитка:  визитка
товар:  товар
формировать:  формировать
акция:  акция
регистрировать:  регистрировать
многие:  многие
житомир:  житомир
демонстрация:  демонстрация
элемент:  элемент
этап:  этап
обсуждение:  обсуждение
разобрать:  разобрать
бренд:  бренд
развитие:  развитие
содержать:  содержать
содержимое:  содержимое
подписание:  подписание
николаев:  николаев
часто:  часто
версия:  версия
выгода:  выгода
смотреть:  смотреть
завоёвывать:  завоёвывать
функция:  функция
протестировать:  протестировать
стремительно:  стремительно
заказать:  заказать
реклама:  реклама
человек:  человек
возникать:  возникать
расширять:  расширять
учёт:  учёт
настройка:  настройка
регион:  регион
договор:  договор
связь:  связь
результат:  результат
имя:  имя
что:  что
отдать:  отдать
заключать:  заключать
стратегия:  стратегия
не:  не
утверждать:  утверждать
лёгкость:  лёгкость
увидеть:  увидеть
счёт:  счёт
продукт:  продукт
черновцы:  черновцы
определение:  определение
формирование:  формирование
метод:  метод
проверить:  проверить
креативность:  креативность
создание:  создание
оптимизация:  оптимизация
количество:  количество
воспользоваться:  воспользоваться
опция:  опция
определиться:  определиться
тестирование:  тестирование
выбор:  выбор
поставщик:  поставщик
действие:  действие
доступно:  доступно
заключаться:  заключаться
технология:  технология
поэтому:  поэтому
магазин:  магазин
рисовать:  рисовать
подключение:  подключение
киев:  киев
проходить:  проходить
инструмент:  инструмент
мы:  мы
создавать:  создавать
готовый:  готовый
психолог:  психолог
вызывать:  вызывать
площадка:  площадка
отдел:  отдел
призыв:  призыв
попадать:  попадать
разработка:  разработка
покупка:  покупка
доступ:  доступ
предприятие:  предприятие
сторона:  сторона
заказ:  заказ
заказчик:  заказчик
раз:  раз
полностью:  полностью
стадия:  стадия
доходность:  доходность
осуществлять:  осуществлять
где:  где
тип:  тип
эффективность:  эффективность
коэффициент:  коэффициент
специалист:  специалист
фаза:  фаза
юлия:  юлия
маркетинг:  маркетинг
оформление:  оформление
прибыль:  прибыль
интенсивность:  интенсивность
тренд:  тренд
привязка:  привязка
рассчитываться:  рассчитываться
максимально:  максимально
подтверждать:  подтверждать
тратить:  тратить
ровно:  ровно
предложить:  предложить
редактор:  редактор
оценка:  оценка
требование:  требование
преимущество:  преимущество
наработка:  наработка
подробный:  подробный
проводить:  проводить
расчёт:  расчёт
необходимо:  необходимо
веб-ресурс:  веб-ресурс
доход:  доход
остаться:  остаться
развиваться:  развиваться
касаться:  касаться
считаться:  считаться
расход:  расход
простота:  простота
оправдать:  оправдать
автоматизация:  автоматизация
заключение:  заключение
востребовать:  востребовать
интернет-проект:  интернет-проект
определять:  определять
разделить:  разделить
телефон:  телефон
владелец:  владелец
подача:  подача
принцип:  принцип
присутствовать:  присутствовать
картинка:  картинка
подавить:  подавить
марк:  марк
сбор:  сбор
способ:  способ
проект:  проект
основа:  основа
контент:  контент
ориентировать:  ориентировать
работа:  работа
концепция:  концепция
город:  город
почти:  почти
появляться:  появляться
разгрузка:  разгрузка
момент:  момент
внести:  внести
всё:  всё
иметь:  иметь
пункт:  пункт
начало:  начало
стать:  стать
вы:  вы
скорость:  скорость
продумывать:  продумывать
идея:  идея
именно:  именно
производитель:  производитель
меню:  меню
проконсультировать:  проконсультировать
евгений:  евгений
вариант:  вариант
знать:  знать
винница:  винница
относиться:  относиться
соответствовать:  соответствовать
доплата:  доплата
взять:  взять
исполнитель:  исполнитель
критерий:  критерий
выдача:  выдача
оплата:  оплата
период:  период
легко:  легко
случай:  случай
увеличить:  увеличить
структура:  структура
связаться:  связаться
данные:  данные
выглядеть:  выглядеть
сдать:  сдать
всегда:  всегда
подход:  подход
зачем:  зачем
название:  название
позиционировать:  позиционировать
составление:  составление
вносить:  вносить
возможность:  возможность
взаимосвязь:  взаимосвязь
приносить:  приносить
удваивать:  удваивать
интернет:  интернет
служба:  служба
вести:  вести
потребитель:  потребитель
пребывание:  пребывание
впечатление:  впечатление
акцентировать:  акцентировать
хороший:  хороший
это:  это
наличие:  наличие
сделать:  сделать
коммуникация:  коммуникация
по-настоящему:  по-настоящему
регистрация:  регистрация
поставить:  поставить
пополнять:  пополнять
собираться:  собираться
выйти:  выйти
повышать:  повышать
пересечение:  пересечение
организация:  организация
быстро:  быстро
информация:  информация
принятие:  принятие
оставаться:  оставаться
браузер:  браузер
интеграция:  интеграция
ресурс:  ресурс
реализовать:  реализовать
инструкция:  инструкция
конверсия:  конверсия
нужно:  нужно
есть:  есть
закрепляться:  закрепляться
обучение:  обучение
превращение:  превращение
тематика:  тематика
днепр:  днепр
разбиваться:  разбиваться
только:  только
число:  число
выбирать:  выбирать
донецк:  донецк
более:  более
беспрерывно:  беспрерывно
нуждаться:  нуждаться
сформировать:  сформировать
сотрудничество:  сотрудничество
директор:  директор
быть:  быть
аренда:  аренда
раздел:  раздел
рабочий:  рабочий
структурировать:  структурировать
контроль:  контроль
оттолкнуть:  оттолкнуть
система:  система
срок:  срок
федерация:  федерация
оставлять:  оставлять
скачать:  скачать
отстроиться:  отстроиться
бизнес:  бизнес
давать:  давать
обеспечить:  обеспечить
иначе:  иначе
гамма:  гамма
интернет-ресурс:  интернет-ресурс
наглядно:  наглядно
веб-сайт:  веб-сайт
планирование:  планирование
спрос:  спрос
предоставлять:  предоставлять
узнать:  узнать
исследование:  исследование
предприниматель:  предприниматель
появление:  появление
просматривать:  просматривать
конфиденциальность:  конфиденциальность
услуга:  услуга
перезвонить:  перезвонить
эффект:  эффект
механизм:  механизм
проверять:  проверять
происходить:  происходить
рог:  рог
гарантия:  гарантия
увеличение:  увеличение
они:  они
обсуждаться:  обсуждаться
открытие:  открытие
задавать:  задавать
пользователь:  пользователь
меняться:  меняться
отвечать:  отвечать
плодотворно:  плодотворно
навигация:  навигация
подбирать:  подбирать
донести:  донести
фраза:  фраза
стабильность:  стабильность
завершать:  завершать
сложно:  сложно
продавать:  продавать
домен:  домен
предпочтение:  предпочтение
учитывать:  учитывать
провести:  провести
приступить:  приступить
возвращаться:  возвращаться
доступный:  доступный
получить:  получить
эмоция:  эмоция
неразглашение:  неразглашение
фактор:  фактор
порядок:  порядок
требовать:  требовать
цель:  цель
отдельно:  отдельно
зайти:  зайти
возраст:  возраст
ориентироваться:  ориентироваться
ведение:  ведение
ооо:  ооо
ознакомиться:  ознакомиться
адрес:  адрес
окрашивать:  окрашивать
деятельность:  деятельность
обращаться:  обращаться
слово:  слово
упорядочить:  упорядочить
следовать:  следовать
делать:  делать
стоимость:  стоимость
провоцировать:  провоцировать
вид:  вид
успешно:  успешно
студия:  студия
соответствие:  соответствие
отличаться:  отличаться
средство:  средство
команда:  команда
цена:  цена
предлагать:  предлагать
итог:  итог
сравнивать:  сравнивать
отзыв:  отзыв
обработка:  обработка
интуитивно:  интуитивно
он:  он
обвинить:  обвинить
стиль:  стиль
год:  год
вступать:  вступать
прикрепить:  прикрепить
описание:  описание
предназначить:  предназначить
внедрение:  внедрение
грамотно:  грамотно
продажа:  продажа
приступать:  приступать
реализация:  реализация
параметр:  параметр
наполнение:  наполнение
зарабатывать:  зарабатывать
развивать:  развивать
дизайн:  дизайн
уделить:  уделить
получать:  получать
интегрировать:  интегрировать
редактировать:  редактировать
подразумевать:  подразумевать
посмотреть:  посмотреть
место:  место
задача:  задача
рассылка:  рассылка
пообщаться:  пообщаться
ссылка:  ссылка
прийти:  прийти
взаимодействие:  взаимодействие
распространение:  распространение
платформа:  платформа
превратить:  превратить
акт:  акт
процедура:  процедура
создаваться:  создаваться
тысяча:  тысяча
время:  время
выполнять:  выполнять
выходить:  выходить
определяться:  определяться
список:  список
запорожье:  запорожье
рейтинг:  рейтинг
направить:  направить
вложить:  вложить
перечень:  перечень
работоспособность:  работоспособность
вёрстка:  вёрстка
превосходить:  превосходить
изучение:  изучение
уделяться:  уделяться
себя:  себя
планировщик:  планировщик
должный:  должный
наполнить:  наполнить
действовать:  действовать
большой:  большой
оттенок:  оттенок
существовать:  существовать
пользоваться:  пользоваться
завоевание:  завоевание
сочетаться:  сочетаться
объём:  объём
подключать:  подключать
безопасность:  безопасность
украина:  украина
оповещение:  оповещение
производительность:  производительность
сила:  сила
модуль:  модуль
планировать:  планировать
лояльность:  лояльность
заинтересовать:  заинтересовать
описать:  описать
включать:  включать
чп:  чп
демонстрировать:  демонстрировать
подробно:  подробно
посетитель:  посетитель
функционал:  функционал
платье:  платье
помогать:  помогать
тема:  тема
проведение:  проведение
использоваться:  использоваться
открываться:  открываться
высота:  высота
предполагать:  предполагать
рынок:  рынок
можно:  можно
функционировать:  функционировать
несколько:  несколько
детально:  детально
блок:  блок
крыться:  крыться
работать:  работать
полтава:  полтава
аудитория:  аудитория
разрабатывать:  разрабатывать
значение:  значение
укреплять:  укреплять
раскручивать:  раскручивать
создать:  создать
начать:  начать
вестись:  вестись
ускорить:  ускорить
важно:  важно
хостинг:  хостинг
знание:  знание
сеть:  сеть
бросаться:  бросаться
расширение:  расширение
выполнение:  выполнение
дополнительно:  дополнительно
увеличивать:  увеличивать
пора:  пора
управление:  управление
официально:  официально
одесса:  одесса
посвятить:  посвятить
разработчик:  разработчик
течение:  течение
веб:  веб
выбрать:  выбрать
подготовить:  подготовить
располагать:  располагать
реакция:  реакция
право:  право
представить:  представить
получение:  получение
удовлетворённость:  удовлетворённость
приоритет:  приоритет
луцк:  луцк
вполне:  вполне
понять:  понять
дать:  дать
оформлять:  оформлять
запомнить:  запомнить
опыт:  опыт
ускорять:  ускорять
видеть:  видеть
поддержка:  поддержка
видео:  видео
сложность:  сложность
бойлер:  бойлер
необходимость:  необходимость
роль:  роль
трудность:  трудность
написать:  написать
собирать:  собирать
нажимать:  нажимать
чернигов:  чернигов
нужный:  нужный
целесообразно:  целесообразно
форма:  форма
многое:  многое
здесь:  здесь
размещение:  размещение
загрузка:  загрузка
консультация:  консультация
обязать:  обязать
много:  много
сотрудник:  сотрудник
ужгород:  ужгород
сверстать:  сверстать
последовательность:  последовательность
кто:  кто
фирма:  фирма
обеспечивать:  обеспечивать
решение:  решение
сталкиваться:  сталкиваться
дело:  дело
просто:  просто
избрать:  избрать
глаз:  глаз
интересовать:  интересовать
платить:  платить
общение:  общение
оба:  оба
позволить:  позволить
невыполнение:  невыполнение
санкция:  санкция
условие:  условие
очень:  очень
черкассы:  черкассы
ошибка:  ошибка
встреча:  встреча
способность:  способность
продукция:  продукция
камень:  камень
добавление:  добавление
занимать:  занимать
составить:  составить
ввод:  ввод
текст:  текст
рассчитать:  рассчитать
квалификация:  квалификация
слишком:  слишком
свойственно:  свойственно
мнение:  мнение
плагиат:  плагиат
харьков:  харьков
база:  база
тщательно:  тщательно
мир:  мир
привлечь:  привлечь
херсон:  херсон
использование:  использование
заместитель:  заместитель
фильтр:  фильтр
планироваться:  планироваться
понятно:  понятно
играть:  играть
тематически:  тематически
сходиться:  сходиться
амбиция:  амбиция
способствовать:  способствовать
предоставление:  предоставление
переходить:  переходить
проектировать:  проектировать
делаться:  делаться
корректировать:  корректировать
добавлять:  добавлять
решать:  решать
убедиться:  убедиться
ключ:  ключ
нравиться:  нравиться
посоветовать:  посоветовать
обязательно:  обязательно
показывать:  показывать
предварительно:  предварительно
ступенька:  ступенька
портал:  портал
влиять:  влиять
имидж:  имидж
страна:  страна
тестировать:  тестировать
мотивация:  мотивация
мешать:  мешать
онлайн:  онлайн
ждать:  ждать
успех:  успех
рост:  рост
канал:  канал
компьютер:  компьютер
точка:  точка
новость:  новость
внимание:  внимание
привести:  привести
сотрудничать:  сотрудничать
оценивать:  оценивать
начинаться:  начинаться
поддерживать:  поддерживать
надёжность:  надёжность
допускать:  допускать
основать:  основать
расти:  расти
резервирование:  резервирование
хорошо:  хорошо
стабильно:  стабильно
прибегнуть:  прибегнуть
модель:  модель
выше:  выше
территория:  территория
позиция:  позиция
отчёт:  отчёт
сфера:  сфера
находить:  находить
предоставить:  предоставить
проигрываться:  проигрываться
утвердить:  утвердить
автоматизировать:  автоматизировать
чётко:  чётко
расписать:  расписать
цвета:  цвета
музыка:  музыка
выполнить:  выполнить
минута:  минута
пройти:  пройти
продумать:  продумать
фон:  фон
затрата:  затрата
бык:  бык
согласие:  согласие
говорить:  говорить
отслеживание:  отслеживание
справиться:  справиться
выгодный:  выгодный
подобрать:  подобрать
гарантировать:  гарантировать
ивано-франковск:  ивано-франковск
цвет:  цвет
распространить:  распространить
склад:  склад
адаптивность:  адаптивность
помощь:  помощь
навсегда:  навсегда
сумах:  сумах
причина:  причина
ядро:  ядро
заявить:  заявить
неправильно:  неправильно
завершение:  завершение
снова:  снова
взаимодействовать:  взаимодействовать
культура:  культура
самостоятельно:  самостоятельно
очередь:  очередь
контакт:  контакт
специализация:  специализация
привлекать:  привлекать
прийтись:  прийтись
наталья:  наталья
тернополь:  тернополь
практика:  практика
поддерживаться:  поддерживаться
львов:  львов
предусмотреть:  предусмотреть
пандемия:  пандемия
вернуться:  вернуться
путь:  путь
макет:  макет
кампания:  кампания
насколько:  насколько
являться:  являться
привлечение:  привлечение
ещё:  ещё
качественно:  качественно
потребность:  потребность
обновление:  обновление
понятный:  понятный
руководитель:  руководитель
ведь:  ведь
часть:  часть
проверка:  проверка
приток:  приток
минимизировать:  минимизировать
психотерапевт:  психотерапевт
значительно:  значительно
мгновенно:  мгновенно
сдача:  сдача
находиться:  находиться
вызывающе:  вызывающе
