продление:  продление
акция:  акция
декабрь:  декабрь
онлайн-сервис:  онлайн-сервис
персонал:  персонал
звонок:  звонок
оптимизировать:  оптимизировать
внедрить:  внедрить
история:  история
документооборот:  документооборот
доверять:  доверять
настроить:  настроить
программа:  программа
контрагент:  контрагент
обслуживание:  обслуживание
форма:  форма
центр:  центр
обучение:  обучение
сопровождение:  сопровождение
рабочий:  рабочий
поток:  поток
каталог:  каталог
управление:  управление
более:  более
зарплата:  зарплата
день:  день
колледж:  колледж
руководитель:  руководитель
рынок:  рынок
сертификация:  сертификация
перенести:  перенести
контроль:  контроль
можно:  можно
конфигурация:  конфигурация
цель:  цель
сотрудничать:  сотрудничать
компания:  компания
клиент:  клиент
дать:  дать
мы:  мы
сервис:  сервис
материал:  материал
магазин:  магазин
внедрение:  внедрение
октябрь:  октябрь
автоматизация:  автоматизация
помощник:  помощник
поддержка:  поддержка
система:  система
услуга:  услуга
сеть:  сеть
компьютер:  компьютер
эксплуатация:  эксплуатация
республика:  республика
карьера:  карьера
новость:  новость
торговля:  торговля
посмотреть:  посмотреть
бизнес:  бизнес
ввод:  ввод
пользователь:  пользователь
усилить:  усилить
получить:  получить
выпуск:  выпуск
выгрузка:  выгрузка
курс:  курс
организация:  организация
антивирус:  антивирус
предприятие:  предприятие
разработчик:  разработчик
начать:  начать
статья:  статья
праздник:  праздник
база:  база
мероприятие:  мероприятие
январь:  январь
продукт:  продукт
бухгалтерия:  бухгалтерия
продажа:  продажа
правило:  правило
башкортостан:  башкортостан
ооо:  ооо
скидка:  скидка
сертификат:  сертификат
консультация:  консультация
обеспечение:  обеспечение
редакция:  редакция
решение:  решение
прайс-лист:  прайс-лист
контакт:  контакт
работа:  работа
контент:  контент
всё:  всё
интернет:  интернет
риск:  риск
рубль:  рубль
режим:  режим
станция:  станция
сервер:  сервер
специалист:  специалист
принцип:  принцип
статус:  статус
склад:  склад
профессионал:  профессионал
разработка:  разработка
воспользоваться:  воспользоваться
программист:  программист
финансы:  финансы
легко:  легко
телефон:  телефон
апрель:  апрель
оборудование:  оборудование
конец:  конец
облако:  облако
фотогалерея:  фотогалерея
наверх:  наверх
год:  год
