март:  март
партнёр:  партнёр
условие:  условие
подготовка:  подготовка
предлагать:  предлагать
обеспечение:  обеспечение
услуга:  услуга
применение:  применение
ранее:  ранее
вернуться:  вернуться
тз:  тз
создание:  создание
направление:  направление
трудозатрата:  трудозатрата
качество:  качество
срок:  срок
интерфейс:  интерфейс
корректировка:  корректировка
не:  не
отобразить:  отобразить
контент:  контент
ранний:  ранний
разобрать:  разобрать
гарантия:  гарантия
июль:  июль
клиент:  клиент
работать:  работать
задание:  задание
выгода:  выгода
совершенно:  совершенно
материал:  материал
раздел:  раздел
большой:  большой
разработка:  разработка
информация:  информация
подробный:  подробный
процесс:  процесс
постараться:  постараться
себя:  себя
вы:  вы
удобно:  удобно
развитие:  развитие
группа:  группа
октябрь:  октябрь
стек:  стек
сила:  сила
обратить:  обратить
позволять:  позволять
специализироваться:  специализироваться
очень:  очень
выбрать:  выбрать
направленность:  направленность
сентябрь:  сентябрь
обязательно:  обязательно
сопровождение:  сопровождение
планшет:  планшет
число:  число
офис:  офис
вид:  вид
часто:  часто
система:  система
более:  более
февраль:  февраль
кейс:  кейс
оценка:  оценка
брать:  брать
просмотр:  просмотр
прототип:  прототип
быть:  быть
коллектив:  коллектив
сдать:  сдать
момент:  момент
много:  много
сложность:  сложность
необходимый:  необходимый
думать:  думать
оно:  оно
собственность:  собственность
интернет:  интернет
профиль:  профиль
ценообразование:  ценообразование
адаптация:  адаптация
это:  это
приносить:  приносить
счёт:  счёт
публикация:  публикация
заказ:  заказ
сегмент:  сегмент
пожаловать:  пожаловать
получить:  получить
сервер:  сервер
компания:  компания
чат:  чат
внимание:  внимание
аудит:  аудит
январь:  январь
усилие:  усилие
помогать:  помогать
исключительно:  исключительно
оценить:  оценить
узнать:  узнать
разрабатывать:  разрабатывать
внедрение:  внедрение
состав:  состав
декабрь:  декабрь
ознакомиться:  ознакомиться
июнь:  июнь
начать:  начать
программирование:  программирование
магазин:  магазин
прикладывать:  прикладывать
принцип:  принцип
работа:  работа
мы:  мы
запуск:  запуск
новость:  новость
портфолио:  портфолио
обеспечивать:  обеспечивать
разрешение:  разрешение
сфера:  сфера
полезный:  полезный
давать:  давать
друг:  друг
версия:  версия
архив:  архив
стоимость:  стоимость
знакомство:  знакомство
проект:  проект
знать:  знать
точно:  точно
представить:  представить
технология:  технология
стать:  стать
август:  август
калькулятор:  калькулятор
где:  где
сайт:  сайт
стараться:  стараться
продукт:  продукт
эффективность:  эффективность
соответствие:  соответствие
делать:  делать
цикл:  цикл
май:  май
бот:  бот
мочь:  мочь
презентация:  презентация
статья:  статья
акция:  акция
довести:  довести
зачем:  зачем
поддержка:  поддержка
практически:  практически
почему:  почему
лаборатория:  лаборатория
входить:  входить
показатель:  показатель
идеология:  идеология
база:  база
приглашать:  приглашать
управление:  управление
требовать:  требовать
цель:  цель
предложить:  предложить
интеграция:  интеграция
методология:  методология
раз:  раз
принадлежать:  принадлежать
сосредоточить:  сосредоточить
ценить:  ценить
умение:  умение
добро:  добро
этап:  этап
преимущество:  преимущество
дизайн:  дизайн
ооо:  ооо
размещение:  размещение
программа:  программа
зависеть:  зависеть
формирование:  формирование
заниматься:  заниматься
окупаться:  окупаться
обмен:  обмен
тип:  тип
стоять:  стоять
студия:  студия
содержаться:  содержаться
успешно:  успешно
профессионал:  профессионал
учить:  учить
ресторан:  ресторан
проектирование:  проектирование
прокрутить:  прокрутить
подготовить:  подготовить
цена:  цена
панель:  панель
привести:  привести
решение:  решение
тестирование:  тестирование
дешёвый:  дешёвый
полезно:  полезно
встретить:  встретить
копирование:  копирование
контакт:  контакт
скорость:  скорость
всё:  всё
он:  он
почти:  почти
предоставлять:  предоставлять
платформа:  платформа
научить:  научить
ориентация:  ориентация
администрирование:  администрирование
познакомиться:  познакомиться
именно:  именно
зарабатывать:  зарабатывать
меню:  меню
рада:  рада
ещё:  ещё
устройство:  устройство
ноябрь:  ноябрь
построение:  построение
скачать:  скачать
взаимодействие:  взаимодействие
создавать:  создавать
изменение:  изменение
апрель:  апрель
данные:  данные
семейство:  семейство
наверх:  наверх
идея:  идея
страница:  страница
поиск:  поиск
