история:  история
проблема:  проблема
компания:  компания
риска:  риска
автоматизация:  автоматизация
рост:  рост
внедрение:  внедрение
проект:  проект
купить:  купить
получать:  получать
превращать:  превращать
деятельность:  деятельность
заинтересовать:  заинтересовать
инвестиция:  инвестиция
коммуникация:  коммуникация
сфера:  сфера
приносить:  приносить
действие:  действие
достаточно:  достаточно
блог:  блог
цель:  цель
вы:  вы
результат:  результат
позволять:  позволять
прилететь:  прилететь
подобрать:  подобрать
продажа:  продажа
ведение:  ведение
поддержка:  поддержка
служба:  служба
комплексно:  комплексно
двигатель:  двигатель
десятка:  десятка
мы:  мы
достигнуть:  достигнуть
источник:  источник
новость:  новость
контакт:  контакт
проводить:  проводить
эффективность:  эффективность
руководство:  руководство
они:  они
это:  это
заказать:  заказать
вариант:  вариант
создание:  создание
глаз:  глаз
грамотно:  грамотно
звонок:  звонок
маркетинг:  маркетинг
решать:  решать
иметься:  иметься
заявка:  заявка
работать:  работать
поиск:  поиск
точка:  точка
партнёр:  партнёр
систематизация:  систематизация
измерение:  измерение
ошибка:  ошибка
кейс:  кейс
опыт:  опыт
рынок:  рынок
клиент:  клиент
работа:  работа
показатель:  показатель
найти:  найти
именно:  именно
разработка:  разработка
отдел:  отдел
москва:  москва
увеличить:  увеличить
туризм:  туризм
ремонт:  ремонт
повышение:  повышение
реклама:  реклама
кто-то:  кто-то
торговля:  торговля
оставить:  оставить
аудит:  аудит
организация:  организация
пакет:  пакет
строительство:  строительство
консалтинг:  консалтинг
подробный:  подробный
идеально:  идеально
критически:  критически
сертификат:  сертификат
всё:  всё
заниматься:  заниматься
сотрудничество:  сотрудничество
входить:  входить
интеграция:  интеграция
недвижимость:  недвижимость
успеть:  успеть
год:  год
высвобождать:  высвобождать
процесс:  процесс
подразделение:  подразделение
статья:  статья
основать:  основать
сократить:  сократить
сайт:  сайт
читать:  читать
запустить:  запустить
выручка:  выручка
хороший:  хороший
не:  не
корректно:  корректно
ещё:  ещё
узнать:  узнать
она:  она
оптимизация:  оптимизация
случай:  случай
нуль:  нуль
лицензия:  лицензия
система:  система
наличие:  наличие
назад:  назад
пора:  пора
внедрять:  внедрять
быстро:  быстро
использовать:  использовать
услуга:  услуга
срок:  срок
определиться:  определиться
месяц:  месяц
отвечать:  отвечать
иерархия:  иерархия
развитие:  развитие
позволить:  позволить
штат:  штат
помогать:  помогать
затрагивать:  затрагивать
отрасль:  отрасль
кто:  кто
потребоваться:  потребоваться
обратиться:  обратиться
доработка:  доработка
сводить:  сводить
информация:  информация
добиваться:  добиваться
настраивать:  настраивать
корректировка:  корректировка
компетенция:  компетенция
способный:  способный
обучение:  обучение
увеличение:  увеличение
решение:  решение
отзыв:  отзыв
билет:  билет
провести:  провести
количество:  количество
выполнить:  выполнить
находиться:  находиться
вносить:  вносить
оценить:  оценить
программист:  программист
объединять:  объединять
сопровождение:  сопровождение
вести:  вести
расширение:  расширение
консультировать:  консультировать
избежать:  избежать
использование:  использование
право:  право
быть:  быть
усилие:  усилие
бизнес-процесс:  бизнес-процесс
абсолютно:  абсолютно
стать:  стать
сотрудник:  сотрудник
прямо:  прямо
команда:  команда
готовый:  готовый
вопрос:  вопрос
настроить:  настроить
выбирать:  выбирать
подключение:  подключение
персонал:  персонал
иногда:  иногда
панацея:  панацея
