подключение:  подключение
уровень:  уровень
работать:  работать
транспортировка:  транспортировка
комбайн:  комбайн
разблокировка:  разблокировка
сократить:  сократить
внесение:  внесение
компания:  компания
добиться:  добиться
эффективность:  эффективность
поволжье:  поволжье
режим:  режим
обслуживание:  обслуживание
дисциплина:  дисциплина
зил:  зил
внедрять:  внедрять
правильно:  правильно
оборудование:  оборудование
поле:  поле
исключить:  исключить
автоматизация:  автоматизация
издержка:  издержка
отчёт:  отчёт
снизить:  снизить
вход:  вход
вводиться:  вводиться
выгода:  выгода
экономия:  экономия
оформить:  оформить
поставка:  поставка
превратиться:  превратиться
отметить:  отметить
повыситься:  повыситься
пресс-центр:  пресс-центр
директор:  директор
решать:  решать
не:  не
автобус:  автобус
тест:  тест
включать:  включать
карта:  карта
внедрение:  внедрение
вождение:  вождение
область:  область
расстояние:  расстояние
интеграция:  интеграция
мониторинг:  мониторинг
расхождение:  расхождение
мы:  мы
готовый:  готовый
хотеть:  хотеть
сумма:  сумма
объект:  объект
предприятие:  предприятие
функционал:  функционал
ежедневно:  ежедневно
топливо:  топливо
вопрос:  вопрос
большой:  большой
тахограф:  тахограф
обрабатывать:  обрабатывать
где:  где
рассчитывать:  рассчитывать
пробег:  пробег
пройти:  пройти
списывать:  списывать
модуль:  модуль
искать:  искать
база:  база
замена:  замена
автомобиль:  автомобиль
заявка:  заявка
бензовоз:  бензовоз
поддерживаться:  поддерживаться
вывести:  вывести
требование:  требование
решение:  решение
напоминать:  напоминать
накрутка:  накрутка
я:  я
исключение:  исключение
расход:  расход
телефон:  телефон
зарекомендовать:  зарекомендовать
контроль:  контроль
белгород:  белгород
система:  система
сбор:  сбор
терминал:  терминал
блок:  блок
стартап:  стартап
поддержка:  поддержка
способ:  способ
срыв:  срыв
работа:  работа
построить:  построить
город:  город
орёл:  орёл
находить:  находить
вместимость:  вместимость
оснастить:  оснастить
тонна:  тонна
комментарий:  комментарий
месяц:  месяц
именно:  именно
имя:  имя
интегрировать:  интегрировать
найти:  найти
сэкономить:  сэкономить
лицензия:  лицензия
период:  период
интегратор:  интегратор
трое:  трое
данные:  данные
всегда:  всегда
обращение:  обращение
глонасс:  глонасс
служба:  служба
вести:  вести
цепочка:  цепочка
плод:  плод
это:  это
автопарк:  автопарк
развозить:  развозить
техобслуживание:  техобслуживание
четыре:  четыре
водитель:  водитель
использование:  использование
талон:  талон
обманывать:  обманывать
спидометр:  спидометр
нужно:  нужно
позволять:  позволять
авторизация:  авторизация
обучение:  обучение
сопровождение:  сопровождение
комплекс:  комплекс
осуществление:  осуществление
содержание:  содержание
число:  число
более:  более
специалист:  специалист
брянск:  брянск
шина:  шина
сотрудничество:  сотрудничество
трек:  трек
статус:  статус
отмечать:  отмечать
калибровка:  калибровка
пятно:  пятно
ставрополь:  ставрополь
сейчас:  сейчас
бизнес:  бизнес
предоставить:  предоставить
июль:  июль
урожайность:  урожайность
несоблюдение:  несоблюдение
ответить:  ответить
подписаться:  подписаться
конфиденциальность:  конфиденциальность
нацелить:  нацелить
эффект:  эффект
происходить:  происходить
снижать:  снижать
автотранспорт:  автотранспорт
вы:  вы
активация:  активация
новость:  новость
газель:  газель
порядок:  порядок
нормирование:  нормирование
единица:  единица
сайт:  сайт
изготовление:  изготовление
кейс:  кейс
приближаться:  приближаться
граница:  граница
вакансия:  вакансия
назад:  назад
партнёр:  партнёр
подарок:  подарок
подробный:  подробный
ооо:  ооо
позвонить:  позвонить
деятельность:  деятельность
транспорт:  транспорт
дед:  дед
команда:  команда
прибор:  прибор
блог:  блог
перевозка:  перевозка
ростов-на-дону:  ростов-на-дону
обработка:  обработка
он:  он
год:  год
атол:  атол
рубль:  рубль
россия:  россия
жизнь:  жизнь
реализация:  реализация
цифра:  цифра
звонок:  звонок
выбрать:  выбрать
аналитика:  аналитика
они:  они
регион:  регион
хозяйство:  хозяйство
проект:  проект
видеонаблюдение:  видеонаблюдение
рождение:  рождение
тип:  тип
платформа:  платформа
время:  время
зао:  зао
урожай:  урожай
политика:  политика
теперь:  теперь
результат:  результат
следить:  следить
пенза:  пенза
срок:  срок
повышение:  повышение
подтверждаться:  подтверждаться
написать:  написать
учёт:  учёт
видеоролик:  видеоролик
себя:  себя
производительность:  производительность
избежать:  избежать
согласный:  согласный
управление:  управление
воронеж:  воронеж
предполагать:  предполагать
указать:  указать
рынок:  рынок
доступ:  доступ
обслуживать:  обслуживать
аграрий:  аграрий
аудит:  аудит
рф:  рф
квартира:  квартира
разрабатывать:  разрабатывать
установка:  установка
краснодар:  краснодар
давать:  давать
рязань:  рязань
байка:  байка
москва:  москва
список:  список
продукт:  продукт
отправить:  отправить
экономить:  экономить
факт:  факт
статья:  статья
видео:  видео
саранск:  саранск
папанов:  папанов
трактор:  трактор
тамбов:  тамбов
камаз:  камаз
сотрудник:  сотрудник
проезд:  проезд
обеспечение:  обеспечение
сокращать:  сокращать
интернет:  интернет
трекер:  трекер
студент:  студент
удаться:  удаться
перерасход:  перерасход
условие:  условие
два:  два
повысить:  повысить
генерироваться:  генерироваться
эффективно:  эффективно
размер:  размер
пропуск:  пропуск
воспользоваться:  воспользоваться
липецк:  липецк
присвоить:  присвоить
меркурий:  меркурий
перейти:  перейти
день:  день
пожинать:  пожинать
диспетчерская:  диспетчерская
развивать:  развивать
белые:  белые
рассчитать:  рассчитать
настройка:  настройка
заправка:  заправка
груз:  груз
запустить:  запустить
кабинет:  кабинет
посещение:  посещение
клип:  клип
техника:  техника
датчик:  датчик
группа:  группа
км:  км
телематика:  телематика
сертификат:  сертификат
клиент:  клиент
контролировать:  контролировать
средство:  средство
вкупе:  вкупе
дыра:  дыра
процесс:  процесс
оао:  оао
метод:  метод
сфера:  сфера
автоматизировать:  автоматизировать
затрата:  затрата
ноль:  ноль
создать:  создать
заранее:  заранее
метеостанция:  метеостанция
лидер:  лидер
приёмка:  приёмка
получать:  получать
сотрудничать:  сотрудничать
оснащение:  оснащение
помощь:  помощь
вещь:  вещь
рекомендация:  рекомендация
курск:  курск
диспетчеризация:  диспетчеризация
нарушение:  нарушение
контакт:  контакт
рекомендовать:  рекомендовать
всё:  всё
объём:  объём
вездеход:  вездеход
большинство:  большинство
специфика:  специфика
передача:  передача
ремонт:  ремонт
исчезать:  исчезать
насколько:  насколько
устройство:  устройство
штат:  штат
являться:  являться
отзыв:  отзыв
быть:  быть
обновление:  обновление
доказать:  доказать
волгоград:  волгоград
заказать:  заказать
значительно:  значительно
находиться:  находиться
