фильм:  фильм
настройка:  настройка
выполнять:  выполнять
доступный:  доступный
подготовка:  подготовка
виза:  виза
применение:  применение
файл:  файл
выявить:  выявить
интересовать:  интересовать
лишь:  лишь
она:  она
почта:  почта
впечатление:  впечатление
вариант:  вариант
рутина:  рутина
использование:  использование
не:  не
фотография:  фотография
компания:  компания
украсить:  украсить
помочь:  помочь
экран:  экран
конвертировать:  конвертировать
календарь:  календарь
программа:  программа
производить:  производить
оформлять:  оформлять
форум:  форум
обработать:  обработать
печать:  печать
решать:  решать
быстро:  быстро
организация:  организация
комбинация:  комбинация
отвлечение:  отвлечение
возможность:  возможность
видеоролик:  видеоролик
ускоритель:  ускоритель
вы:  вы
открывать:  открывать
многое:  многое
защита:  защита
формат:  формат
визитка:  визитка
студия:  студия
сотня:  сотня
добавлять:  добавлять
включать:  включать
продукт:  продукт
позволять:  позволять
нужно:  нужно
сопровождение:  сопровождение
запуск:  запуск
только:  только
число:  число
предварительно:  предварительно
каталог:  каталог
они:  они
оформить:  оформить
пакет:  пакет
более:  более
мастер:  мастер
человек:  человек
скачивать:  скачивать
титр:  титр
год:  год
снимать:  снимать
заниматься:  заниматься
обрабатывать:  обрабатывать
кликнуть:  кликнуть
документ:  документ
конверт:  конверт
можно:  можно
онлайн:  онлайн
бейдж:  бейдж
утилита:  утилита
несколько:  несколько
это:  это
создавать:  создавать
резко:  резко
компьютер:  компьютер
профессионально:  профессионально
оформление:  оформление
потрясать:  потрясать
приносить:  приносить
текст:  текст
встроить:  встроить
записать:  записать
открытка:  открытка
учёт:  учёт
прочее:  прочее
услуга:  услуга
карточка:  карточка
создать:  создать
система:  система
стать:  стать
эффект:  эффект
радость:  радость
устранять:  устранять
удостоверение:  удостоверение
шаблон:  шаблон
выбор:  выбор
соединять:  соединять
тысяча:  тысяча
обучать:  обучать
работать:  работать
сканирование:  сканирование
причина:  причина
разработчик:  разработчик
видео:  видео
давать:  давать
функция:  функция
носитель:  носитель
заставка:  заставка
снимок:  снимок
интерьер:  интерьер
точно:  точно
мебель:  мебель
диск:  диск
преобразить:  преобразить
избавлять:  избавлять
запись:  запись
сократить:  сократить
минута:  минута
сайт:  сайт
продумать:  продумать
предоставлять:  предоставлять
эффективность:  эффективность
лист:  лист
квартира:  квартира
экспортировать:  экспортировать
выбрать:  выбрать
стремиться:  стремиться
соответствие:  соответствие
улучшение:  улучшение
требование:  требование
буквально:  буквально
подобрать:  подобрать
входить:  входить
просто:  просто
иметься:  иметься
очистка:  очистка
обработка:  обработка
приветствовать:  приветствовать
видеоклип:  видеоклип
вид:  вид
изготавливать:  изготавливать
музыка:  музыка
комплект:  комплект
управление:  управление
подарить:  подарить
редактор:  редактор
расположить:  расположить
воспользоваться:  воспользоваться
улучшать:  улучшать
продавать:  продавать
гордиться:  гордиться
помощь:  помощь
дизайн:  дизайн
здесь:  здесь
создание:  создание
уменьшить:  уменьшить
фото:  фото
загрузка:  загрузка
загрузить:  загрузить
подготовить:  подготовить
ретушировать:  ретушировать
приглашение:  приглашение
ретушь:  ретушь
выложить:  выложить
рамка:  рамка
найти:  найти
камера:  камера
монтировать:  монтировать
информация:  информация
провести:  провести
время:  время
получить:  получить
быть:  быть
команда:  команда
мы:  мы
он:  он
работа:  работа
всё:  всё
реестр:  реестр
вывод:  вывод
гость:  гость
фотоснимок:  фотоснимок
предназначить:  предназначить
редактирование:  редактирование
собрать:  собрать
вдохновлять:  вдохновлять
передача:  передача
записывать:  записывать
перенести:  перенести
конвертирование:  конвертирование
изготовление:  изготовление
оптимизация:  оптимизация
видеостудия:  видеостудия
собирать:  собирать
меню:  меню
ускорение:  ускорение
повысить:  повысить
разработать:  разработать
приставка:  приставка
конвертация:  конвертация
позволить:  позволить
будущее:  будущее
качественно:  качественно
простор:  простор
редактировать:  редактировать
разрабатывать:  разрабатывать
продукция:  продукция
образ:  образ
руководитель:  руководитель
превратить:  превратить
легко:  легко
смонтировать:  смонтировать
пейзаж:  пейзаж
страна:  страна
пара:  пара
мгновенно:  мгновенно
добавить:  добавить
страница:  страница
копирование:  копирование
