компания:  компания
цех:  цех
управление:  управление
пользователь:  пользователь
партнёр:  партнёр
среднее:  среднее
заявка:  заявка
встраиваться:  встраиваться
звонок:  звонок
сфера:  сфера
заниматься:  заниматься
купить:  купить
рынок:  рынок
сайт:  сайт
поиск:  поиск
заказ:  заказ
приобрести:  приобрести
решение:  решение
разработка:  разработка
сервис:  сервис
внедрение:  внедрение
степень:  степень
вестись:  вестись
развивать:  развивать
канал:  канал
сократить:  сократить
магазин:  магазин
это:  это
работа:  работа
ознакомиться:  ознакомиться
вы:  вы
производство:  производство
очень:  очень
сэкономить:  сэкономить
смочь:  смочь
процесс:  процесс
франчайзи:  франчайзи
помощник:  помощник
отправка:  отправка
продажа:  продажа
выходить:  выходить
данные:  данные
телеграмма:  телеграмма
интеграция:  интеграция
хотеть:  хотеть
закупка:  закупка
подходить:  подходить
автоматизировать:  автоматизировать
требование:  требование
модуль:  модуль
предлагать:  предлагать
часть:  часть
позволять:  позволять
продукт:  продукт
согласие:  согласие
что:  что
предприятие:  предприятие
выбор:  выбор
интегрироваться:  интегрироваться
программа:  программа
выполнять:  выполнять
открыть:  открыть
более:  более
выставление:  выставление
интернет-магазин:  интернет-магазин
счёт:  счёт
использовать:  использовать
заказать:  заказать
телефон:  телефон
работать:  работать
имя:  имя
построение:  построение
база:  база
лицензия:  лицензия
учитывать:  учитывать
функционал:  функционал
поддержка:  поддержка
товар:  товар
время:  время
учёт:  учёт
услуга:  услуга
бизнес:  бизнес
дорабатывать:  дорабатывать
страница:  страница
ведение:  ведение
создание:  создание
увидеть:  увидеть
веб-сервис:  веб-сервис
покупка:  покупка
конфигурация:  конфигурация
установка:  установка
год:  год
комплекс:  комплекс
кросс:  кросс
обмен:  обмен
не:  не
идеально:  идеально
запчасть:  запчасть
разработать:  разработать
возможный:  возможный
параллельно:  параллельно
оформление:  оформление
поставщик:  поставщик
довольный:  довольный
создать:  создать
сопровождение:  сопровождение
автоматизация:  автоматизация
доступный:  доступный
материал:  материал
проброс:  проброс
иметься:  иметься
альфа:  альфа
система:  система
стать:  стать
обработка:  обработка
проект:  проект
клиент:  клиент
ремонт:  ремонт
день:  день
подключать:  подключать
документ:  документ
интегрировать:  интегрировать
инструкция:  инструкция
карточка:  карточка
город:  город
просто:  просто
мы:  мы
можно:  можно
помочь:  помочь
постоянно:  постоянно
релиз:  релиз
упорядочивание:  упорядочивание
явно:  явно
облегчить:  облегчить
карла:  карла
увеличить:  увеличить
легко:  легко
обслуживание:  обслуживание
