подключение:  подключение
анализ:  анализ
предлагать:  предлагать
бизнес-процесс:  бизнес-процесс
допускать:  допускать
вагон:  вагон
преимущество:  преимущество
вариант:  вариант
не:  не
комплекс:  комплекс
инструмент:  инструмент
повышение:  повышение
залог:  залог
эффективность:  эффективность
парк:  парк
компания:  компания
продукт:  продукт
клиент:  клиент
многогранность:  многогранность
источник:  источник
выявление:  выявление
поэтому:  поэтому
комплектация:  комплектация
потребность:  потребность
правильно:  правильно
информация:  информация
принимать:  принимать
владелец:  владелец
подходить:  подходить
процесс:  процесс
себя:  себя
интеграция:  интеграция
депо:  депо
автоматизация:  автоматизация
опыт:  опыт
позволять:  позволять
груз:  груз
решать:  решать
цена:  цена
никто:  никто
поставка:  поставка
подразделение:  подразделение
перевозка:  перевозка
состоять:  состоять
сотрудничество:  сотрудничество
пройти:  пройти
сложность:  сложность
квалифицировать:  квалифицировать
предприятие:  предприятие
задача:  задача
рынок:  рынок
доступ:  доступ
онлайн:  онлайн
исполнение:  исполнение
нарушение:  нарушение
производить:  производить
это:  это
бизнес:  бизнес
получить:  получить
разработка:  разработка
группа:  группа
рост:  рост
разрабатывать:  разрабатывать
контейнер:  контейнер
удовлетворять:  удовлетворять
область:  область
конфиденциальность:  конфиденциальность
система:  система
оао:  оао
соглашение:  соглашение
эксплуатация:  эксплуатация
операция:  операция
вы:  вы
новость:  новость
дислокация:  дислокация
автоматизировать:  автоматизировать
право:  право
управлять:  управлять
функционал:  функционал
участие:  участие
технология:  технология
качество:  качество
состояние:  состояние
оптимизация:  оптимизация
презентация:  презентация
показатель:  показатель
улучшение:  улучшение
партнёр:  партнёр
поддержка:  поддержка
прогнозирование:  прогнозирование
гарантия:  гарантия
сотрудничать:  сотрудничать
пк:  пк
прошедшее:  прошедшее
управление:  управление
услуга:  услуга
универсальность:  универсальность
бесплатно:  бесплатно
подробный:  подробный
программа:  программа
загрузка:  загрузка
деятельность:  деятельность
зарекомендовать:  зарекомендовать
успешно:  успешно
обеспечение:  обеспечение
отслеживание:  отслеживание
решение:  решение
заказчик:  заказчик
надёжность:  надёжность
сервис:  сервис
офис:  офис
команда:  команда
обработка:  обработка
попробовать:  попробовать
работа:  работа
контакт:  контакт
мы:  мы
год:  год
предоставление:  предоставление
приобретать:  приобретать
всё:  всё
вконтакте:  вконтакте
профиль:  профиль
научиться:  научиться
общество:  общество
ао:  ао
экономически:  экономически
портал:  портал
найти:  найти
внедрение:  внедрение
являться:  являться
отзыв:  отзыв
знать:  знать
принцип:  принцип
собственник:  собственник
получать:  получать
специалист:  специалист
часть:  часть
взаимодействие:  взаимодействие
факт:  факт
заявка:  заявка
данные:  данные
время:  время
политика:  политика
поиск:  поиск
