повышение:  повышение
персонал:  персонал
производство:  производство
доставка:  доставка
поставка:  поставка
звонок:  звонок
история:  история
результат:  результат
принятие:  принятие
компания:  компания
эффективность:  эффективность
проект:  проект
ряд:  ряд
электрум:  электрум
использование:  использование
вопрос:  вопрос
кола:  кола
заказ:  заказ
расписание:  расписание
июнь:  июнь
расчёт:  расчёт
транспорт:  транспорт
логистика:  логистика
продукт:  продукт
груз:  груз
позволять:  позволять
внедрение:  внедрение
масштаб:  масштаб
мусоровоз:  мусоровоз
объезд:  объезд
год:  год
они:  они
учёт:  учёт
среда:  среда
кока:  кока
изменяться:  изменяться
создавать:  создавать
построить:  построить
интернет:  интернет
презентация:  презентация
группа:  группа
завершить:  завершить
сборка:  сборка
новость:  новость
набрать:  набрать
аудит:  аудит
бензовоз:  бензовоз
технология:  технология
доработка:  доработка
создание:  создание
сервис:  сервис
подготовить:  подготовить
задать:  задать
подходить:  подходить
бригада:  бригада
услуга:  услуга
ответ:  ответ
автоматизация:  автоматизация
система:  система
быть:  быть
гибкость:  гибкость
оао:  оао
магазин:  магазин
условие:  условие
принцип:  принцип
мы:  мы
управление:  управление
партнёр:  партнёр
июль:  июль
сфера:  сфера
бизнес:  бизнес
право:  право
клиент:  клиент
создать:  создать
вывоз:  вывоз
интеграция:  интеграция
предназначить:  предназначить
объединить:  объединить
особенность:  особенность
улучшение:  улучшение
консультация:  консультация
самоорганизация:  самоорганизация
интегрировать:  интегрировать
применение:  применение
статья:  статья
реквизит:  реквизит
поддержка:  поддержка
сотрудник:  сотрудник
видео:  видео
май:  май
предприятие:  предприятие
точка:  точка
подтверждать:  подтверждать
подразделение:  подразделение
использовать:  использовать
заказчик:  заказчик
маршрут:  маршрут
помощь:  помощь
ответить:  ответить
обеспечивать:  обеспечивать
октябрь:  октябрь
иметься:  иметься
стоимость:  стоимость
иса:  иса
объект:  объект
масштабируемость:  масштабируемость
решение:  решение
время:  время
работа:  работа
контакт:  контакт
март:  март
мониторинг:  мониторинг
всё:  всё
срок:  срок
предоставление:  предоставление
уровень:  уровень
радость:  радость
найти:  найти
являться:  являться
конкурентоспособность:  конкурентоспособность
портфель:  портфель
качественно:  качественно
произвести:  произвести
обслуживание:  обслуживание
стать:  стать
заказать:  заказать
лицензия:  лицензия
формирование:  формирование
задача:  задача
холдинг:  холдинг
адаптироваться:  адаптироваться
направление:  направление
процесс:  процесс
реорганизация:  реорганизация
ресурс:  ресурс
