опыт:  опыт
каталог:  каталог
сеть:  сеть
сценарий:  сценарий
процесс:  процесс
программа:  программа
выбытие:  выбытие
большой:  большой
марка:  марка
шаг:  шаг
помогать:  помогать
касса:  касса
автоматизация:  автоматизация
продукт:  продукт
автоматизировать:  автоматизировать
президент:  президент
обслуживание:  обслуживание
сервис:  сервис
решаться:  решаться
это:  это
инструмент:  инструмент
директор:  директор
дом:  дом
публикация:  публикация
кабинет:  кабинет
ответ:  ответ
использовать:  использовать
фнс:  фнс
магазин:  магазин
операция:  операция
новость:  новость
работать:  работать
ит:  ит
разработка:  разработка
адрес:  адрес
получить:  получить
вопрос:  вопрос
внедрять:  внедрять
сокращать:  сокращать
технология:  технология
сайт:  сайт
переход:  переход
борисович:  борисович
загрузка:  загрузка
гарантия:  гарантия
поддержка:  поддержка
перейти:  перейти
блог:  блог
управление:  управление
самообслуживание:  самообслуживание
связь:  связь
помощь:  помощь
ооо:  ооо
подробный:  подробный
расход:  расход
включить:  включить
сбор:  сбор
обновлять:  обновлять
он:  он
мы:  мы
гк:  гк
всё:  всё
кристалл:  кристалл
обработка:  обработка
портал:  портал
выбрать:  выбрать
очень:  очень
запустить:  запустить
регион:  регион
руководитель:  руководитель
проект:  проект
оборудование:  оборудование
данные:  данные
февраль:  февраль
политика:  политика
