обязательный:  обязательный
деталь:  деталь
интерфейс:  интерфейс
мониторинг:  мониторинг
номер:  номер
условие:  условие
креатив:  креатив
стратегия:  стратегия
парковка:  парковка
передача:  передача
ряд:  ряд
система:  система
составление:  составление
бесплатно:  бесплатно
выполняться:  выполняться
клуб:  клуб
готовый:  готовый
заявка:  заявка
ответ:  ответ
сайт:  сайт
сотрудник:  сотрудник
оценка:  оценка
увеличить:  увеличить
предъявлять:  предъявлять
сеть:  сеть
комплекс:  комплекс
мы:  мы
уточнять:  уточнять
ошибка:  ошибка
работать:  работать
иметь:  иметь
решение:  решение
разработка:  разработка
услуга:  услуга
информация:  информация
всё:  всё
принимать:  принимать
задание:  задание
что-то:  что-то
заказ:  заказ
несколько:  несколько
производительность:  производительность
функционал:  функционал
состоять:  состоять
зависеть:  зависеть
право:  право
вы:  вы
информатизация:  информатизация
база:  база
труд:  труд
создать:  создать
требоваться:  требоваться
приходить:  приходить
авиакомпания:  авиакомпания
использовать:  использовать
клиент:  клиент
повышение:  повышение
субд:  субд
осуществлять:  осуществлять
отправить:  отправить
вести:  вести
продажа:  продажа
управление:  управление
уточнение:  уточнение
инструмент:  инструмент
число:  число
режим:  режим
внимание:  внимание
обеспечение:  обеспечение
обсуждение:  обсуждение
требование:  требование
терять:  терять
ресурс:  ресурс
учёт:  учёт
карта:  карта
оператор:  оператор
предлагать:  предлагать
реализовать:  реализовать
создание:  создание
позволять:  позволять
контакт:  контакт
срок:  срок
контроль:  контроль
обработка:  обработка
правило:  правило
доработка:  доработка
интегрироваться:  интегрироваться
производство:  производство
стоимость:  стоимость
показатель:  показатель
повысить:  повысить
допускаться:  допускаться
компания:  компания
продукт:  продукт
разрабатывать:  разрабатывать
заказать:  заказать
разработчик:  разработчик
обычно:  обычно
демонстрация:  демонстрация
программа:  программа
согласие:  согласие
этап:  этап
получение:  получение
довольно:  довольно
рекомендация:  рекомендация
лицензия:  лицензия
площадка:  площадка
взаимоотношение:  взаимоотношение
тестирование:  тестирование
отметить:  отметить
непосредственно:  непосредственно
обеспечивать:  обеспечивать
работа:  работа
бизнес:  бизнес
риск:  риск
развернуть:  развернуть
пробел:  пробел
распознавание:  распознавание
оценить:  оценить
провести:  провести
штат:  штат
цель:  цель
автоматизация:  автоматизация
пожалуйста:  пожалуйста
заказчик:  заказчик
навык:  навык
изучать:  изучать
обсуждать:  обсуждать
включать:  включать
объём:  объём
внедрение:  внедрение
данные:  данные
подробный:  подробный
освоение:  освоение
интеграция:  интеграция
метод:  метод
себя:  себя
запланировать:  запланировать
совершенствование:  совершенствование
видеть:  видеть
средство:  средство
проектировать:  проектировать
выполнение:  выполнение
входить:  входить
вопрос:  вопрос
бизнес-модель:  бизнес-модель
область:  область
это:  это
холдинг:  холдинг
планирование:  планирование
нарушение:  нарушение
дать:  дать
фиксация:  фиксация
сверка:  сверка
оставить:  оставить
пространство:  пространство
предоставлять:  предоставлять
акция:  акция
технология:  технология
сводка:  сводка
опыт:  опыт
впервые:  впервые
течение:  течение
согласование:  согласование
почувствовать:  почувствовать
получить:  получить
пример:  пример
она:  она
телефон:  телефон
деньга:  деньга
оборудование:  оборудование
счёт:  счёт
создавать:  создавать
технически:  технически
специалист:  специалист
решать:  решать
прозрачность:  прозрачность
профиль:  профиль
состав:  состав
соответствовать:  соответствовать
задача:  задача
предприятие:  предприятие
проект:  проект
отвечать:  отвечать
понимать:  понимать
анализ:  анализ
правонарушение:  правонарушение
проявить:  проявить
поддержка:  поддержка
подготовка:  подготовка
согласовывать:  согласовывать
использование:  использование
москва:  москва
сценарий:  сценарий
интуитивно:  интуитивно
вариант:  вариант
пдд:  пдд
внести:  внести
эксплуатация:  эксплуатация
опция:  опция
он:  он
сопровождение:  сопровождение
одновременно:  одновременно
позволить:  позволить
только:  только
точность:  точность
уровень:  уровень
возникнуть:  возникнуть
аудит:  аудит
выполнять:  выполнять
частность:  частность
апк:  апк
идентификация:  идентификация
карьера:  карьера
знак:  знак
