бухгалтерия:  бухгалтерия
акция:  акция
клиент:  клиент
она:  она
удалённый:  удалённый
дата:  дата
специалист:  специалист
стандартно:  стандартно
процесс:  процесс
компания:  компания
помогать:  помогать
храниться:  храниться
добиться:  добиться
протокол:  протокол
комментарий:  комментарий
оформлять:  оформлять
дать:  дать
обслуживание:  обслуживание
сравнить:  сравнить
настраивать:  настраивать
отчётность:  отчётность
ответить:  ответить
выбрать:  выбрать
занимать:  занимать
потребность:  потребность
привязка:  привязка
правильно:  правильно
специфика:  специфика
отчёт:  отчёт
оставлять:  оставлять
демонстрация:  демонстрация
запланировать:  запланировать
литва:  литва
версия:  версия
успешность:  успешность
задача:  задача
поиск:  поиск
невозможность:  невозможность
год:  год
авиаперевозка:  авиаперевозка
сборная:  сборная
автоматически:  автоматически
связь:  связь
высвободиться:  высвободиться
не:  не
увеличение:  увеличение
удобно:  удобно
получить:  получить
привлечь:  привлечь
нужный:  нужный
день:  день
доработка:  доработка
количество:  количество
защитить:  защитить
крайне:  крайне
попробовать:  попробовать
внедрение:  внедрение
техподдержка:  техподдержка
неудобно:  неудобно
ответственность:  ответственность
конкурент:  конкурент
счёт:  счёт
заполнить:  заполнить
регулировать:  регулировать
программа:  программа
думать:  думать
хранить:  хранить
эстония:  эстония
справочник:  справочник
мы:  мы
лётный:  лётный
хотеть:  хотеть
занять:  занять
отдел:  отдел
становиться:  становиться
попадать:  попадать
протестировать:  протестировать
посмотреть:  посмотреть
вели:  вели
доступ:  доступ
месяц:  месяц
функционал:  функционал
стоимость:  стоимость
заказ:  заказ
раз:  раз
вопрос:  вопрос
контейнер:  контейнер
где:  где
эффективность:  эффективность
он:  он
вносить:  вносить
груз:  груз
сейчас:  сейчас
фактор:  фактор
документ:  документ
облегчать:  облегчать
данные:  данные
сообщение:  сообщение
уровень:  уровень
прибыль:  прибыль
осуществлять:  осуществлять
блок:  блок
учёт:  учёт
маленький:  маленький
прикрепить:  прикрепить
искать:  искать
записаться:  записаться
пользователь:  пользователь
работать:  работать
база:  база
формат:  формат
знание:  знание
тратить:  тратить
заявка:  заявка
прозрачность:  прозрачность
автоматизировать:  автоматизировать
маршрут:  маршрут
преимущество:  преимущество
экспедитор:  экспедитор
простой:  простой
сократить:  сократить
тип:  тип
повторно:  повторно
автоматизация:  автоматизация
выписка:  выписка
быстрый:  быстрый
нагрузка:  нагрузка
сбор:  сбор
состояние:  состояние
ответ:  ответ
перенаправить:  перенаправить
работа:  работа
учитывать:  учитывать
получиться:  получиться
машина:  машина
сохранность:  сохранность
облако:  облако
появляться:  появляться
всё:  всё
восстановимый:  восстановимый
офис:  офис
перегружать:  перегружать
вы:  вы
спасибо:  спасибо
отсылать:  отсылать
система:  система
долго:  долго
найти:  найти
транспорт:  транспорт
сбой:  сбой
картина:  картина
детальный:  детальный
перенести:  перенести
формирование:  формирование
решение:  решение
логист:  логист
увеличить:  увеличить
исполнитель:  исполнитель
польша:  польша
бухгалтер:  бухгалтер
получать:  получать
переделка:  переделка
отладить:  отладить
хранение:  хранение
калькулятор:  калькулятор
возможность:  возможность
командировка:  командировка
бизнес-процесс:  бизнес-процесс
скачивать:  скачивать
лишь:  лишь
вести:  вести
кирилл:  кирилл
рутина:  рутина
это:  это
статистика:  статистика
выстраивать:  выстраивать
канал:  канал
нужда:  нужда
вернуть:  вернуть
организация:  организация
быстро:  быстро
повышать:  повышать
внедрить:  внедрить
видеть:  видеть
информация:  информация
снизить:  снизить
есть:  есть
нужно:  нужно
всегда:  всегда
кредит:  кредит
более:  более
пользоваться:  пользоваться
сервер:  сервер
проблема:  проблема
статус:  статус
допускать:  допускать
ндс:  ндс
германия:  германия
бизнес:  бизнес
директор:  директор
путаться:  путаться
скорректировать:  скорректировать
контролировать:  контролировать
перенос:  перенос
рейс:  рейс
запрос:  запрос
настроить:  настроить
появление:  появление
сотрудничество:  сотрудничество
сторона:  сторона
рекомендовать:  рекомендовать
конфиденциальность:  конфиденциальность
сканировать:  сканировать
проверять:  проверять
отслеживать:  отслеживать
формировать:  формировать
звонить:  звонить
оперативно:  оперативно
сокращение:  сокращение
разграничивать:  разграничивать
индикатор:  индикатор
исключать:  исключать
номер:  номер
обеспечивать:  обеспечивать
они:  они
подписка:  подписка
заполнять:  заполнять
украина:  украина
ошибка:  ошибка
сложно:  сложно
продолжить:  продолжить
заниматься:  заниматься
адаптировать:  адаптировать
презентация:  презентация
переслать:  переслать
мочь:  мочь
копия:  копия
создание:  создание
выполнение:  выполнение
создавать:  создавать
течение:  течение
отвечать:  отвечать
отправка:  отправка
бесплатно:  бесплатно
понравиться:  понравиться
увеличиться:  увеличиться
превзойти:  превзойти
ознакомиться:  ознакомиться
европа:  европа
планирование:  планирование
ускориться:  ускориться
оформить:  оформить
условие:  условие
предназначить:  предназначить
успешно:  успешно
избавляться:  избавляться
выстроить:  выстроить
специализировать:  специализировать
просматривать:  просматривать
перевозка:  перевозка
восстановить:  восстановить
облегчить:  облегчить
отправлять:  отправлять
аренда:  аренда
обработка:  обработка
интуитивно:  интуитивно
хранилище:  хранилище
объединить:  объединить
написать:  написать
передавать:  передавать
провести:  провести
безопасность:  безопасность
вводить:  вводить
учесть:  учесть
часть:  часть
грамотно:  грамотно
ещё:  ещё
защита:  защита
подгружаться:  подгружаться
вырасти:  вырасти
шаблон:  шаблон
сразу:  сразу
клик:  клик
скачок:  скачок
сайт:  сайт
стать:  стать
сокращать:  сокращать
прямо:  прямо
место:  место
предоставить:  предоставить
потеря:  потеря
николай:  николай
биржа:  биржа
создаваться:  создаваться
обучение:  обучение
обучить:  обучить
время:  время
предприятие:  предприятие
скачать:  скачать
зао:  зао
юля:  юля
политика:  политика
задействовать:  задействовать
остановка:  остановка
теперь:  теперь
выявить:  выявить
строить:  строить
перевозить:  перевозить
грузоперевозка:  грузоперевозка
немаловажный:  немаловажный
посетить:  посетить
большой:  большой
перерыв:  перерыв
видеоролик:  видеоролик
название:  название
кук:  кук
перейти:  перейти
рекомендация:  рекомендация
лояльность:  лояльность
обрабатывать:  обрабатывать
бессистемность:  бессистемность
право:  право
сотрудник:  сотрудник
доставлять:  доставлять
использовать:  использовать
возвращать:  возвращать
указать:  указать
рынок:  рынок
можно:  можно
несколько:  несколько
оформление:  оформление
затем:  затем
рф:  рф
проконтролировать:  проконтролировать
дело:  дело
неделя:  неделя
установка:  установка
реализовать:  реализовать
дебет:  дебет
немой:  немой
давать:  давать
адрес:  адрес
позволить:  позволить
преодолеть:  преодолеть
вручную:  вручную
многие:  многие
ставка:  ставка
зона:  зона
прийти:  прийти
команда:  команда
делать:  делать
блог:  блог
необходимость:  необходимость
инструкция:  инструкция
интеграция:  интеграция
подключить:  подключить
проверить:  проверить
услуга:  услуга
идеально:  идеально
начать:  начать
форма:  форма
зависеть:  зависеть
экспортировать:  экспортировать
много:  много
кто:  кто
просто:  просто
увеличивать:  увеличивать
требовать:  требовать
оставаться:  оставаться
общение:  общение
нина:  нина
очень:  очень
подтягивать:  подтягивать
наладиться:  наладиться
добиваться:  добиваться
алгоритм:  алгоритм
вид:  вид
сводить:  сводить
отрываться:  отрываться
страна:  страна
примерно:  примерно
код:  код
подтягиваться:  подтягиваться
прислать:  прислать
выполнять:  выполнять
товар:  товар
сохраняться:  сохраняться
мир:  мир
таблица:  таблица
читать:  читать
освобождать:  освобождать
экономить:  экономить
ранний:  ранний
кнопка:  кнопка
настройка:  настройка
оплата:  оплата
поездка:  поездка
большинство:  большинство
невозможно:  невозможно
указывать:  указывать
почта:  почта
результат:  результат
отзыв:  отзыв
кабинет:  кабинет
решать:  решать
никто:  никто
освободиться:  освободиться
понятный:  понятный
тариф:  тариф
азербайджан:  азербайджан
моделирование:  моделирование
узбекистан:  узбекистан
назад:  назад
шифровать:  шифровать
рост:  рост
оперировать:  оперировать
потому:  потому
влиять:  влиять
смочь:  смочь
сфера:  сфера
видео:  видео
лимит:  лимит
удалёнка:  удалёнка
минута:  минута
россия:  россия
продажа:  продажа
компьютер:  компьютер
казахстан:  казахстан
интересовать:  интересовать
запросить:  запросить
остаться:  остаться
быть:  быть
поддержка:  поддержка
загрузить:  загрузить
затеряться:  затеряться
гарантировать:  гарантировать
общаться:  общаться
передаваться:  передаваться
обратиться:  обратиться
управление:  управление
интегрироваться:  интегрироваться
помощь:  помощь
взаимодействие:  взаимодействие
ведение:  ведение
руководитель:  руководитель
ускорить:  ускорить
снова:  снова
состав:  состав
контакт:  контакт
беларусь:  беларусь
валюта:  валюта
анализировать:  анализировать
составление:  составление
станция:  станция
выставлять:  выставлять
путь:  путь
качественно:  качественно
обновление:  обновление
смотреть:  смотреть
расширять:  расширять
заказать:  заказать
хотеться:  хотеться
телефон:  телефон
происходить:  происходить
выходить:  выходить
этап:  этап
я:  я
деньга:  деньга
реагировать:  реагировать
латвия:  латвия
