ставка:  ставка
кошелёк:  кошелёк
мешать:  мешать
потребоваться:  потребоваться
использовать:  использовать
извлекаться:  извлекаться
источник:  источник
попадать:  попадать
использование:  использование
адаптировать:  адаптировать
помочь:  помочь
страница:  страница
ничто:  ничто
зеркало:  зеркало
рабочий:  рабочий
помнить:  помнить
действовать:  действовать
имя:  имя
часто:  часто
приступить:  приступить
ввести:  ввести
контора:  контора
поиск:  поиск
недостаток:  недостаток
связь:  связь
счёт:  счёт
рука:  рука
получить:  получить
воспользоваться:  воспользоваться
территория:  территория
комфорт:  комфорт
пополнение:  пополнение
действительно:  действительно
доступно:  доступно
предлагать:  предлагать
поэтому:  поэтому
инструмент:  инструмент
она:  она
блокировка:  блокировка
комиссия:  комиссия
полностью:  полностью
значок:  значок
нет:  нет
где:  где
начинать:  начинать
сообщение:  сообщение
вывод:  вывод
процедура:  процедура
перейти:  перейти
оказаться:  оказаться
пользователь:  пользователь
сохраняться:  сохраняться
площадка:  площадка
автоматически:  автоматически
карта:  карта
снятие:  снятие
необходимо:  необходимо
повторно:  повторно
вводить:  вводить
контроль:  контроль
стоить:  стоить
десяток:  десяток
интерфейс:  интерфейс
проведение:  проведение
отправить:  отправить
нахождение:  нахождение
возникать:  возникать
внести:  внести
открыть:  открыть
перевод:  перевод
вариант:  вариант
найти:  найти
легко:  легко
пока:  пока
связаться:  связаться
адрес:  адрес
всегда:  всегда
востребовать:  востребовать
возможность:  возможность
сайт:  сайт
это:  это
сделать:  сделать
продумать:  продумать
норма:  норма
ресурс:  ресурс
есть:  есть
нужно:  нужно
позволять:  позволять
игрок:  игрок
только:  только
число:  число
рекомендоваться:  рекомендоваться
иметь:  иметь
быть:  быть
кликнуть:  кликнуть
комбинация:  комбинация
здесь:  здесь
отображаться:  отображаться
сейчас:  сейчас
раздел:  раздел
доступ:  доступ
специально:  специально
посетить:  посетить
обычно:  обычно
можно:  можно
входить:  входить
ответ:  ответ
оперативно:  оперативно
состояние:  состояние
дисциплина:  дисциплина
выбор:  выбор
вы:  вы
напрямую:  напрямую
ничего:  ничего
вход:  вход
стремиться:  стремиться
мочь:  мочь
логин:  логин
требовать:  требовать
беспокоиться:  беспокоиться
регистрироваться:  регистрироваться
корректно:  корректно
способ:  способ
менять:  менять
возможный:  возможный
устройство:  устройство
стать:  стать
следовать:  следовать
мониторинг:  мониторинг
вид:  вид
средство:  средство
разместить:  разместить
депозит:  депозит
обновлять:  обновлять
забывать:  забывать
ночь:  ночь
постоянно:  постоянно
клиент:  клиент
подключить:  подключить
находиться:  находиться
занять:  занять
прямо:  прямо
важно:  важно
ссылка:  ссылка
время:  время
скачать:  скачать
он:  он
день:  день
ранее:  ранее
ряд:  ряд
преимущество:  преимущество
телефон:  телефон
существовать:  существовать
служба:  служба
зайти:  зайти
несколько:  несколько
информация:  информация
своевременно:  своевременно
периодически:  периодически
обратить:  обратить
сбросить:  сбросить
составлять:  составлять
частый:  частый
избежать:  избежать
вносить:  вносить
функциональность:  функциональность
войти:  войти
участвовать:  участвовать
пересмотреть:  пересмотреть
настоятельно:  настоятельно
создать:  создать
начать:  начать
вестись:  вестись
сеть:  сеть
пройти:  пройти
рассмотреть:  рассмотреть
веб-сайт:  веб-сайт
чат:  чат
наличие:  наличие
законодательство:  законодательство
выбрать:  выбрать
достаточно:  достаточно
система:  система
никогда:  никогда
получение:  получение
список:  список
многие:  многие
учёт:  учёт
подобрать:  подобрать
оператор:  оператор
поддержка:  поддержка
деятельность:  деятельность
необходимость:  необходимость
переплата:  переплата
написать:  написать
они:  они
получиться:  получиться
мы:  мы
форма:  форма
снять:  снять
зависимость:  зависимость
увеличить:  увеличить
много:  много
сколько:  сколько
отличаться:  отличаться
регистрация:  регистрация
вызывать:  вызывать
бонус:  бонус
компания:  компания
решение:  решение
просто:  просто
попробовать:  попробовать
выглядеть:  выглядеть
интернет:  интернет
выполнение:  выполнение
шифрование:  шифрование
представить:  представить
создавать:  создавать
час:  час
попадаться:  попадаться
покупатель:  покупатель
не:  не
порог:  порог
быстрый:  быстрый
прийти:  прийти
сегодня:  сегодня
структура:  структура
кабинет:  кабинет
ожидание:  ожидание
причина:  причина
портал:  портал
запрос:  запрос
завсегдатай:  завсегдатай
контент:  контент
хотеть:  хотеть
получать:  получать
освобождать:  освобождать
онлайн:  онлайн
рискнуть:  рискнуть
игра:  игра
дать:  дать
новость:  новость
отдельно:  отдельно
хорошо:  хорошо
копия:  копия
номер:  номер
минута:  минута
делать:  делать
история:  история
букмекер:  букмекер
транзакция:  транзакция
искать:  искать
администратор:  администратор
наиболее:  наиболее
помощь:  помощь
осуществляться:  осуществляться
подбор:  подбор
иметься:  иметься
пароль:  пароль
альтернатива:  альтернатива
учитываться:  учитываться
снова:  снова
большинство:  большинство
выполняться:  выполняться
самостоятельно:  самостоятельно
команда:  команда
всё:  всё
оплата:  оплата
проверить:  проверить
роскомнадзор:  роскомнадзор
являться:  являться
платформа:  платформа
переноситься:  переноситься
понятный:  понятный
практически:  практически
