анимация:  анимация
литература:  литература
пост:  пост
обеспечение:  обеспечение
лишь:  лишь
безопасность:  безопасность
почта:  почта
делиться:  делиться
телефон:  телефон
не:  не
компонент:  компонент
экран:  экран
финансы:  финансы
программа:  программа
софт:  софт
поймать:  поймать
настройка:  настройка
конвертер:  конвертер
загружать:  загружать
видеть:  видеть
возможность:  возможность
сервер:  сервер
раскладка:  раскладка
веб-камера:  веб-камера
анонимность:  анонимность
браузер:  браузер
платёж:  платёж
рабочий:  рабочий
решать:  решать
дополнение:  дополнение
версия:  версия
благодарить:  благодарить
программирование:  программирование
архиватор:  архиватор
портал:  портал
главное:  главное
скриншот:  скриншот
качать:  качать
кодек:  кодек
публикация:  публикация
можно:  можно
обновляться:  обновляться
случай:  случай
написать:  написать
блокировка:  блокировка
игра:  игра
качалка:  качалка
сеть:  сеть
администрирование:  администрирование
документ:  документ
драйвер:  драйвер
система:  система
иконка:  иконка
меню:  меню
мы:  мы
юмор:  юмор
ссылка:  ссылка
графика:  графика
редактор:  редактор
только:  только
шифрование:  шифрование
диагностика:  диагностика
офис:  офис
диск:  диск
сайт:  сайт
стараться:  стараться
антивирус:  антивирус
захват:  захват
эмуляция:  эмуляция
навигатор:  навигатор
создание:  создание
активатор:  активатор
обои:  обои
общение:  общение
ключ:  ключ
радио:  радио
подгрузить:  подгрузить
собрать:  собрать
бесплатно:  бесплатно
реклама:  реклама
обслуживание:  обслуживание
проигрыватель:  проигрыватель
заставка:  заставка
хотеть:  хотеть
восстановление:  восстановление
устройство:  устройство
исключать:  исключать
вы:  вы
пароль:  пароль
читалка:  читалка
мультимедиа:  мультимедиа
где:  где
ресурс:  ресурс
пополняться:  пополняться
постоянно:  постоянно
всё:  всё
файл:  файл
интернет:  интернет
база:  база
попутно:  попутно
карта:  карта
публиковаться:  публиковаться
навигация:  навигация
раздел:  раздел
оформление:  оформление
хранилище:  хранилище
текст:  текст
разработчик:  разработчик
найти:  найти
скачивание:  скачивание
стол:  стол
скачать:  скачать
оставить:  оставить
просмотр:  просмотр
конвертация:  конвертация
