возможность:  возможность
акция:  акция
взаимоотношение:  взаимоотношение
применение:  применение
звонок:  звонок
телекоммуникация:  телекоммуникация
выбрать:  выбрать
история:  история
договор:  договор
доверять:  доверять
не:  не
сделать:  сделать
компания:  компания
удобство:  удобство
эффективность:  эффективность
показатель:  показатель
функционал:  функционал
разграничение:  разграничение
клиент:  клиент
центр:  центр
большой:  большой
потребность:  потребность
информация:  информация
учёт:  учёт
специфика:  специфика
торговля:  торговля
сертификация:  сертификация
дек:  дек
вы:  вы
узнать:  узнать
среднее:  среднее
автоматизация:  автоматизация
объём:  объём
развитие:  развитие
попробовать:  попробовать
производительность:  производительность
есть:  есть
позволять:  позволять
продукт:  продукт
лояльность:  лояльность
партнёр:  партнёр
интеграция:  интеграция
он:  он
внедрение:  внедрение
сфера:  сфера
только:  только
год:  год
избежать:  избежать
более:  более
реклама:  реклама
услуга:  услуга
маркетинг:  маркетинг
рынок:  рынок
доступ:  доступ
выставление:  выставление
онлайн:  онлайн
можно:  можно
это:  это
бизнес:  бизнес
сервис:  сервис
новость:  новость
мы:  мы
день:  день
задать:  задать
сотрудник:  сотрудник
обновление:  обновление
подарок:  подарок
поздравлять:  поздравлять
расширить:  расширить
создать:  создать
смочь:  смочь
персонализировать:  персонализировать
упаковка:  упаковка
тест-драйв:  тест-драйв
система:  система
реализация:  реализация
методология:  методология
доступно:  доступно
работа:  работа
получить:  получить
сотрудничество:  сотрудничество
отчёт:  отчёт
повысить:  повысить
автоматизировать:  автоматизировать
скидка:  скидка
полиграфия:  полиграфия
право:  право
полностью:  полностью
минута:  минута
присваиваться:  присваиваться
продажа:  продажа
требование:  требование
отправить:  отправить
кейс:  кейс
освоить:  освоить
строительство:  строительство
счёт:  счёт
презентация:  презентация
поддержка:  поддержка
опыт:  опыт
решить:  решить
работать:  работать
управление:  управление
отправка:  отправка
население:  население
решение:  решение
интернет-магазин:  интернет-магазин
преимущество:  преимущество
подробный:  подробный
хостинг:  хостинг
платформа:  платформа
хотеть:  хотеть
ограничение:  ограничение
программа:  программа
дистрибуция:  дистрибуция
увеличить:  увеличить
производство:  производство
бизнес-процесс:  бизнес-процесс
занимать:  занимать
цена:  цена
вопрос:  вопрос
злоумышленник:  злоумышленник
малое:  малое
простота:  простота
быть:  быть
преддверие:  преддверие
держать:  держать
контакт:  контакт
интерфейс:  интерфейс
снижать:  снижать
всё:  всё
открыть:  открыть
изменить:  изменить
настраивать:  настраивать
аналитика:  аналитика
консалтинг:  консалтинг
шаблон:  шаблон
эффективно:  эффективно
позволить:  позволить
заявка:  заявка
тэк:  тэк
заказать:  заказать
проект:  проект
легко:  легко
точка:  точка
конец:  конец
обучение:  обучение
значительно:  значительно
список:  список
документация:  документация
добавить:  добавить
копирование:  копирование
